YEAR,CASES,CAUSE,TOTAL INJURED,MALE INJURED,FEMALE KILLED,FEMALE INJURED,MALE KILLED,STATE/UT,TOTAL KILLED
2013,993,ELECTROCUTION,15,13,153,2,855,ANDHRA PRADESH,1008
2013,401,GAS CYLINDER/STOVE BURST,9,5,318,4,93,ANDHRA PRADESH,411
2013,15,FIRE-ARMS,0,0,11,0,4,ANDHRA PRADESH,15
2013,334,SUDDEN DEATHS(HEART ATTACKS),0,0,30,0,305,ANDHRA PRADESH,335
2013,245,EPILEPTIC FITS/GIDDINESS,0,0,45,0,203,ANDHRA PRADESH,248
2013,14,ABORTIONS/CHILD BIRTH,0,0,14,0,0,ANDHRA PRADESH,14
2013,264,INFLUENCE OF ALCOHOL,0,0,5,0,260,ANDHRA PRADESH,265
2013,186,FOOD POISIONING/ACCIDENTAL INTAKE OF INSECTICIDES ETC.,0,0,47,0,146,ANDHRA PRADESH,193
2013,674,SNAKE BITE/ANIMAL BITE,0,0,228,0,446,ANDHRA PRADESH,674
2013,1465,OTHER,5,4,367,1,1100,ANDHRA PRADESH,1467
2013,2742,OTHER RAILWAY ACCIDENTS,656,572,354,84,2405,ANDHRA PRADESH,2759
2013,1264,OTHER,4,1,242,3,1035,ANDHRA PRADESH,1277
2013,2617,TOTAL DROWNING,20,18,570,2,2221,ANDHRA PRADESH,2791
2013,1465,TOTAL FALLS,51,43,228,8,1228,ANDHRA PRADESH,1456
2013,1730,TOTAL FIRE,38,24,1014,14,756,ANDHRA PRADESH,1770
2013,857,TOTAL SUDDEN DEATHS,0,0,94,0,768,ANDHRA PRADESH,862
2013,2414,TOTAL POISONING,5,4,666,1,1759,ANDHRA PRADESH,2425
2013,3,ELECTROCUTION,0,0,0,0,3,ARUNACHAL PRADESH,3
2013,0,GAS CYLINDER/STOVE BURST,0,0,0,0,0,ARUNACHAL PRADESH,0
2013,3,FIRE-ARMS,0,0,0,0,3,ARUNACHAL PRADESH,3
2013,16,SUDDEN DEATHS(HEART ATTACKS),0,0,2,0,14,ARUNACHAL PRADESH,16
2013,0,EPILEPTIC FITS/GIDDINESS,0,0,0,0,0,ARUNACHAL PRADESH,0
2013,0,ABORTIONS/CHILD BIRTH,0,0,0,0,0,ARUNACHAL PRADESH,0
2013,1,INFLUENCE OF ALCOHOL,0,0,0,0,1,ARUNACHAL PRADESH,1
2013,1,FOOD POISIONING/ACCIDENTAL INTAKE OF INSECTICIDES ETC.,0,0,1,0,0,ARUNACHAL PRADESH,1
2013,0,SNAKE BITE/ANIMAL BITE,0,0,0,0,0,ARUNACHAL PRADESH,0
2013,24,OTHER,0,0,4,0,20,ARUNACHAL PRADESH,24
2013,0,OTHER RAILWAY ACCIDENTS,0,0,0,0,0,ARUNACHAL PRADESH,0
2013,2,OTHER,0,0,0,0,2,ARUNACHAL PRADESH,2
2013,46,TOTAL DROWNING,0,0,8,0,38,ARUNACHAL PRADESH,46
2013,24,TOTAL FALLS,0,0,1,0,23,ARUNACHAL PRADESH,24
2013,7,TOTAL FIRE,0,0,7,0,4,ARUNACHAL PRADESH,11
2013,17,TOTAL SUDDEN DEATHS,0,0,2,0,15,ARUNACHAL PRADESH,17
2013,25,TOTAL POISONING,0,0,5,0,20,ARUNACHAL PRADESH,25
2013,56,ELECTROCUTION,0,0,10,0,48,ASSAM,58
2013,14,GAS CYLINDER/STOVE BURST,0,0,12,0,2,ASSAM,14
2013,14,FIRE-ARMS,0,0,2,0,12,ASSAM,14
2013,54,SUDDEN DEATHS(HEART ATTACKS),0,0,4,0,50,ASSAM,54
2013,0,EPILEPTIC FITS/GIDDINESS,0,0,0,0,0,ASSAM,0
2013,0,ABORTIONS/CHILD BIRTH,0,0,0,0,0,ASSAM,0
2013,5,INFLUENCE OF ALCOHOL,1,1,0,0,5,ASSAM,5
2013,0,FOOD POISIONING/ACCIDENTAL INTAKE OF INSECTICIDES ETC.,0,0,0,0,0,ASSAM,0
2013,4,SNAKE BITE/ANIMAL BITE,0,0,0,0,4,ASSAM,4
2013,196,OTHER,0,0,85,0,111,ASSAM,196
2013,450,OTHER RAILWAY ACCIDENTS,0,0,78,0,372,ASSAM,450
2013,102,OTHER,0,0,29,0,73,ASSAM,102
2013,449,TOTAL DROWNING,0,0,106,0,361,ASSAM,467
2013,27,TOTAL FALLS,0,0,1,0,26,ASSAM,27
2013,136,TOTAL FIRE,0,0,105,0,39,ASSAM,144
2013,59,TOTAL SUDDEN DEATHS,1,1,4,0,55,ASSAM,59
2013,200,TOTAL POISONING,0,0,85,0,115,ASSAM,200
2013,224,ELECTROCUTION,14,11,37,3,187,BIHAR,224
2013,77,GAS CYLINDER/STOVE BURST,13,2,66,11,15,BIHAR,81
2013,64,FIRE-ARMS,31,27,4,4,43,BIHAR,47
2013,121,SUDDEN DEATHS(HEART ATTACKS),11,6,12,5,98,BIHAR,110
2013,62,EPILEPTIC FITS/GIDDINESS,12,8,8,4,42,BIHAR,50
2013,39,ABORTIONS/CHILD BIRTH,0,0,39,0,0,BIHAR,39
2013,164,INFLUENCE OF ALCOHOL,15,11,8,4,148,BIHAR,156
2013,345,FOOD POISIONING/ACCIDENTAL INTAKE OF INSECTICIDES ETC.,25,18,154,7,197,BIHAR,351
2013,31,SNAKE BITE/ANIMAL BITE,1,1,11,0,19,BIHAR,30
2013,244,OTHER,36,24,74,12,134,BIHAR,208
2013,1788,OTHER RAILWAY ACCIDENTS,0,0,325,0,1472,BIHAR,1797
2013,338,OTHER,70,51,86,19,262,BIHAR,348
2013,717,TOTAL DROWNING,123,78,166,45,520,BIHAR,686
2013,125,TOTAL FALLS,22,14,20,8,92,BIHAR,112
2013,421,TOTAL FIRE,62,31,281,31,129,BIHAR,410
2013,386,TOTAL SUDDEN DEATHS,38,25,67,13,288,BIHAR,355
2013,671,TOTAL POISONING,82,63,245,19,384,BIHAR,629
2013,513,ELECTROCUTION,0,0,78,0,435,CHHATTISGARH,513
2013,17,GAS CYLINDER/STOVE BURST,0,0,13,0,4,CHHATTISGARH,17
2013,84,FIRE-ARMS,0,0,8,0,76,CHHATTISGARH,84
2013,234,SUDDEN DEATHS(HEART ATTACKS),0,0,35,0,199,CHHATTISGARH,234
2013,62,EPILEPTIC FITS/GIDDINESS,0,0,13,0,49,CHHATTISGARH,62
2013,15,ABORTIONS/CHILD BIRTH,0,0,15,0,0,CHHATTISGARH,15
2013,286,INFLUENCE OF ALCOHOL,0,0,27,0,259,CHHATTISGARH,286
2013,296,FOOD POISIONING/ACCIDENTAL INTAKE OF INSECTICIDES ETC.,0,0,124,0,172,CHHATTISGARH,296
2013,780,SNAKE BITE/ANIMAL BITE,0,0,351,0,429,CHHATTISGARH,780
2013,445,OTHER,0,0,150,0,295,CHHATTISGARH,445
2013,595,OTHER RAILWAY ACCIDENTS,0,0,106,0,489,CHHATTISGARH,595
2013,2468,OTHER,0,0,664,0,1808,CHHATTISGARH,2472
2013,1657,TOTAL DROWNING,0,0,479,0,1251,CHHATTISGARH,1730
2013,408,TOTAL FALLS,9,9,80,0,328,CHHATTISGARH,408
2013,1008,TOTAL FIRE,0,0,709,0,302,CHHATTISGARH,1011
2013,597,TOTAL SUDDEN DEATHS,0,0,90,0,507,CHHATTISGARH,597
2013,1524,TOTAL POISONING,0,0,626,0,898,CHHATTISGARH,1524
2013,16,ELECTROCUTION,0,0,3,0,13,GOA,16
2013,8,GAS CYLINDER/STOVE BURST,0,0,5,0,2,GOA,7
2013,0,FIRE-ARMS,0,0,0,0,0,GOA,0
2013,12,SUDDEN DEATHS(HEART ATTACKS),0,0,2,0,10,GOA,12
2013,5,EPILEPTIC FITS/GIDDINESS,0,0,1,0,4,GOA,5
2013,1,ABORTIONS/CHILD BIRTH,0,0,1,0,0,GOA,1
2013,7,INFLUENCE OF ALCOHOL,0,0,0,0,7,GOA,7
2013,2,FOOD POISIONING/ACCIDENTAL INTAKE OF INSECTICIDES ETC.,0,0,0,0,2,GOA,2
2013,3,SNAKE BITE/ANIMAL BITE,0,0,0,0,3,GOA,3
2013,1,OTHER,0,0,0,0,1,GOA,1
2013,41,OTHER RAILWAY ACCIDENTS,0,0,3,0,38,GOA,41
2013,53,OTHER,3,2,16,1,38,GOA,54
2013,138,TOTAL DROWNING,0,0,18,0,135,GOA,153
2013,101,TOTAL FALLS,1,1,9,0,106,GOA,115
2013,23,TOTAL FIRE,0,0,18,0,7,GOA,25
2013,25,TOTAL SUDDEN DEATHS,0,0,4,0,21,GOA,25
2013,6,TOTAL POISONING,0,0,0,0,6,GOA,6
2013,615,ELECTROCUTION,9,6,102,3,522,GUJARAT,624
2013,570,GAS CYLINDER/STOVE BURST,0,0,453,0,115,GUJARAT,568
2013,9,FIRE-ARMS,0,0,5,0,4,GUJARAT,9
2013,2898,SUDDEN DEATHS(HEART ATTACKS),2,2,324,0,2572,GUJARAT,2896
2013,682,EPILEPTIC FITS/GIDDINESS,1,1,136,0,548,GUJARAT,684
2013,54,ABORTIONS/CHILD BIRTH,0,0,54,0,0,GUJARAT,54
2013,25,INFLUENCE OF ALCOHOL,1,1,1,0,23,GUJARAT,24
2013,431,FOOD POISIONING/ACCIDENTAL INTAKE OF INSECTICIDES ETC.,14,10,146,4,277,GUJARAT,423
2013,487,SNAKE BITE/ANIMAL BITE,35,19,182,16,273,GUJARAT,455
2013,581,OTHER,3,0,152,3,427,GUJARAT,579
2013,1212,OTHER RAILWAY ACCIDENTS,0,0,168,0,1053,GUJARAT,1221
2013,2655,OTHER,51,41,583,10,2046,GUJARAT,2629
2013,1964,TOTAL DROWNING,3,2,313,1,1696,GUJARAT,2009
2013,1510,TOTAL FALLS,42,32,230,10,1259,GUJARAT,1489
2013,2242,TOTAL FIRE,70,23,1437,47,775,GUJARAT,2212
2013,3659,TOTAL SUDDEN DEATHS,4,4,515,0,3143,GUJARAT,3658
2013,1545,TOTAL POISONING,52,29,494,23,1011,GUJARAT,1505
2013,426,ELECTROCUTION,0,0,31,0,395,HARYANA,426
2013,108,GAS CYLINDER/STOVE BURST,0,0,77,0,31,HARYANA,108
2013,12,FIRE-ARMS,0,0,2,0,10,HARYANA,12
2013,650,SUDDEN DEATHS(HEART ATTACKS),0,0,56,0,594,HARYANA,650
2013,55,EPILEPTIC FITS/GIDDINESS,0,0,7,0,48,HARYANA,55
2013,23,ABORTIONS/CHILD BIRTH,2,0,23,2,0,HARYANA,23
2013,320,INFLUENCE OF ALCOHOL,0,0,0,0,320,HARYANA,320
2013,404,FOOD POISIONING/ACCIDENTAL INTAKE OF INSECTICIDES ETC.,0,0,99,0,305,HARYANA,404
2013,61,SNAKE BITE/ANIMAL BITE,0,0,13,0,48,HARYANA,61
2013,264,OTHER,0,0,88,0,176,HARYANA,264
2013,1331,OTHER RAILWAY ACCIDENTS,0,0,142,0,1189,HARYANA,1331
2013,1254,OTHER,0,0,201,0,1046,HARYANA,1247
2013,588,TOTAL DROWNING,0,0,91,0,498,HARYANA,589
2013,329,TOTAL FALLS,0,0,42,0,287,HARYANA,329
2013,325,TOTAL FIRE,0,0,162,0,163,HARYANA,325
2013,1048,TOTAL SUDDEN DEATHS,2,0,86,2,962,HARYANA,1048
2013,733,TOTAL POISONING,0,0,202,0,531,HARYANA,733
2013,17,ELECTROCUTION,0,0,4,0,13,HIMACHAL PRADESH,17
2013,8,GAS CYLINDER/STOVE BURST,0,0,1,0,7,HIMACHAL PRADESH,8
2013,2,FIRE-ARMS,0,0,0,0,2,HIMACHAL PRADESH,2
2013,194,SUDDEN DEATHS(HEART ATTACKS),0,0,11,0,183,HIMACHAL PRADESH,194
2013,4,EPILEPTIC FITS/GIDDINESS,0,0,0,0,4,HIMACHAL PRADESH,4
2013,5,ABORTIONS/CHILD BIRTH,0,0,5,0,0,HIMACHAL PRADESH,5
2013,65,INFLUENCE OF ALCOHOL,0,0,1,0,64,HIMACHAL PRADESH,65
2013,156,FOOD POISIONING/ACCIDENTAL INTAKE OF INSECTICIDES ETC.,0,0,55,0,101,HIMACHAL PRADESH,156
2013,33,SNAKE BITE/ANIMAL BITE,0,0,12,0,21,HIMACHAL PRADESH,33
2013,102,OTHER,0,0,39,0,63,HIMACHAL PRADESH,102
2013,20,OTHER RAILWAY ACCIDENTS,0,0,5,0,18,HIMACHAL PRADESH,23
2013,275,OTHER,45,31,49,14,228,HIMACHAL PRADESH,277
2013,190,TOTAL DROWNING,0,0,24,0,167,HIMACHAL PRADESH,191
2013,350,TOTAL FALLS,0,0,60,0,290,HIMACHAL PRADESH,350
2013,93,TOTAL FIRE,0,0,42,0,52,HIMACHAL PRADESH,94
2013,268,TOTAL SUDDEN DEATHS,0,0,17,0,251,HIMACHAL PRADESH,268
2013,293,TOTAL POISONING,0,0,108,0,185,HIMACHAL PRADESH,293
2013,25,ELECTROCUTION,1,1,0,0,24,JAMMU & KASHMIR,24
2013,2,GAS CYLINDER/STOVE BURST,2,2,5,0,1,JAMMU & KASHMIR,6
2013,17,FIRE-ARMS,35,35,1,0,23,JAMMU & KASHMIR,24
2013,57,SUDDEN DEATHS(HEART ATTACKS),0,0,2,0,55,JAMMU & KASHMIR,57
2013,0,EPILEPTIC FITS/GIDDINESS,0,0,0,0,0,JAMMU & KASHMIR,0
2013,0,ABORTIONS/CHILD BIRTH,0,0,0,0,0,JAMMU & KASHMIR,0
2013,7,INFLUENCE OF ALCOHOL,0,0,0,0,7,JAMMU & KASHMIR,7
2013,19,FOOD POISIONING/ACCIDENTAL INTAKE OF INSECTICIDES ETC.,2,2,9,0,9,JAMMU & KASHMIR,18
2013,0,SNAKE BITE/ANIMAL BITE,0,0,0,0,0,JAMMU & KASHMIR,0
2013,96,OTHER,36,8,19,28,14,JAMMU & KASHMIR,33
2013,7,OTHER RAILWAY ACCIDENTS,0,0,0,0,7,JAMMU & KASHMIR,7
2013,127,OTHER,0,0,12,0,112,JAMMU & KASHMIR,124
2013,57,TOTAL DROWNING,1,1,15,0,41,JAMMU & KASHMIR,56
2013,43,TOTAL FALLS,0,0,2,0,41,JAMMU & KASHMIR,43
2013,20,TOTAL FIRE,3,3,12,0,15,JAMMU & KASHMIR,27
2013,64,TOTAL SUDDEN DEATHS,0,0,2,0,62,JAMMU & KASHMIR,64
2013,115,TOTAL POISONING,38,10,28,28,23,JAMMU & KASHMIR,51
2013,113,ELECTROCUTION,5,3,28,2,104,JHARKHAND,132
2013,46,GAS CYLINDER/STOVE BURST,7,0,34,7,13,JHARKHAND,47
2013,2,FIRE-ARMS,0,0,0,0,2,JHARKHAND,2
2013,114,SUDDEN DEATHS(HEART ATTACKS),0,0,22,0,94,JHARKHAND,116
2013,32,EPILEPTIC FITS/GIDDINESS,0,0,6,0,26,JHARKHAND,32
2013,21,ABORTIONS/CHILD BIRTH,0,0,21,0,0,JHARKHAND,21
2013,150,INFLUENCE OF ALCOHOL,0,0,10,0,143,JHARKHAND,153
2013,173,FOOD POISIONING/ACCIDENTAL INTAKE OF INSECTICIDES ETC.,19,11,70,8,86,JHARKHAND,156
2013,45,SNAKE BITE/ANIMAL BITE,2,1,21,1,27,JHARKHAND,48
2013,88,OTHER,21,21,32,0,56,JHARKHAND,88
2013,493,OTHER RAILWAY ACCIDENTS,0,0,69,0,424,JHARKHAND,493
2013,439,OTHER,17,12,86,5,364,JHARKHAND,450
2013,412,TOTAL DROWNING,60,54,98,6,271,JHARKHAND,369
2013,208,TOTAL FALLS,5,4,36,1,178,JHARKHAND,214
2013,365,TOTAL FIRE,8,1,255,7,118,JHARKHAND,373
2013,317,TOTAL SUDDEN DEATHS,0,0,59,0,263,JHARKHAND,322
2013,343,TOTAL POISONING,44,35,131,9,193,JHARKHAND,324
2013,436,ELECTROCUTION,4,3,75,1,365,KARNATAKA,440
2013,260,GAS CYLINDER/STOVE BURST,0,0,185,0,80,KARNATAKA,265
2013,14,FIRE-ARMS,0,0,3,0,11,KARNATAKA,14
2013,641,SUDDEN DEATHS(HEART ATTACKS),0,0,72,0,571,KARNATAKA,643
2013,152,EPILEPTIC FITS/GIDDINESS,0,0,22,0,131,KARNATAKA,153
2013,21,ABORTIONS/CHILD BIRTH,0,0,21,0,0,KARNATAKA,21
2013,408,INFLUENCE OF ALCOHOL,0,0,15,0,402,KARNATAKA,417
2013,119,FOOD POISIONING/ACCIDENTAL INTAKE OF INSECTICIDES ETC.,0,0,34,0,85,KARNATAKA,119
2013,541,SNAKE BITE/ANIMAL BITE,0,0,202,0,340,KARNATAKA,542
2013,1076,OTHER,4,2,284,2,806,KARNATAKA,1090
2013,1261,OTHER RAILWAY ACCIDENTS,0,0,346,0,915,KARNATAKA,1261
2013,1647,OTHER,0,0,341,0,1277,KARNATAKA,1618
2013,1934,TOTAL DROWNING,0,0,505,0,1491,KARNATAKA,1996
2013,469,TOTAL FALLS,1,1,57,0,411,KARNATAKA,468
2013,1310,TOTAL FIRE,0,0,871,0,450,KARNATAKA,1321
2013,1222,TOTAL SUDDEN DEATHS,0,0,130,0,1104,KARNATAKA,1234
2013,1813,TOTAL POISONING,4,2,548,2,1281,KARNATAKA,1829
2013,225,ELECTROCUTION,4,4,22,0,202,KERALA,224
2013,18,GAS CYLINDER/STOVE BURST,0,0,15,0,4,KERALA,19
2013,2,FIRE-ARMS,1,1,0,0,1,KERALA,1
2013,1983,SUDDEN DEATHS(HEART ATTACKS),0,0,246,0,1737,KERALA,1983
2013,176,EPILEPTIC FITS/GIDDINESS,0,0,39,0,137,KERALA,176
2013,8,ABORTIONS/CHILD BIRTH,0,0,8,0,0,KERALA,8
2013,193,INFLUENCE OF ALCOHOL,0,0,2,0,192,KERALA,194
2013,21,FOOD POISIONING/ACCIDENTAL INTAKE OF INSECTICIDES ETC.,0,0,8,0,13,KERALA,21
2013,74,SNAKE BITE/ANIMAL BITE,0,0,27,0,47,KERALA,74
2013,126,OTHER,0,0,41,0,85,KERALA,126
2013,427,OTHER RAILWAY ACCIDENTS,0,0,55,0,373,KERALA,428
2013,623,OTHER,0,0,135,0,488,KERALA,623
2013,1609,TOTAL DROWNING,2,2,337,0,1316,KERALA,1653
2013,862,TOTAL FALLS,20,10,89,10,767,KERALA,856
2013,325,TOTAL FIRE,15,9,200,6,128,KERALA,328
2013,2360,TOTAL SUDDEN DEATHS,0,0,295,0,2066,KERALA,2361
2013,221,TOTAL POISONING,0,0,76,0,145,KERALA,221
2013,2030,ELECTROCUTION,16,12,359,4,1675,MADHYA PRADESH,2034
2013,172,GAS CYLINDER/STOVE BURST,2,2,144,0,30,MADHYA PRADESH,174
2013,179,FIRE-ARMS,55,51,14,4,121,MADHYA PRADESH,135
2013,912,SUDDEN DEATHS(HEART ATTACKS),2,2,160,0,759,MADHYA PRADESH,919
2013,169,EPILEPTIC FITS/GIDDINESS,0,0,49,0,122,MADHYA PRADESH,171
2013,186,ABORTIONS/CHILD BIRTH,0,0,186,0,0,MADHYA PRADESH,186
2013,518,INFLUENCE OF ALCOHOL,0,0,17,0,505,MADHYA PRADESH,522
2013,2007,FOOD POISIONING/ACCIDENTAL INTAKE OF INSECTICIDES ETC.,21,14,837,7,1177,MADHYA PRADESH,2014
2013,2385,SNAKE BITE/ANIMAL BITE,10,4,1054,6,1336,MADHYA PRADESH,2390
2013,232,OTHER,17,5,98,12,133,MADHYA PRADESH,231
2013,1721,OTHER RAILWAY ACCIDENTS,2,1,286,1,1435,MADHYA PRADESH,1721
2013,4045,OTHER,204,187,1071,17,3010,MADHYA PRADESH,4081
2013,4921,TOTAL DROWNING,25,14,1491,11,3450,MADHYA PRADESH,4941
2013,1043,TOTAL FALLS,6,5,191,1,854,MADHYA PRADESH,1045
2013,3130,TOTAL FIRE,16,9,2236,7,898,MADHYA PRADESH,3134
2013,1785,TOTAL SUDDEN DEATHS,2,2,412,0,1386,MADHYA PRADESH,1798
2013,4666,TOTAL POISONING,51,26,1993,25,2684,MADHYA PRADESH,4677
2013,1754,ELECTROCUTION,259,214,215,45,1312,MAHARASHTRA,1527
2013,457,GAS CYLINDER/STOVE BURST,39,8,318,31,115,MAHARASHTRA,433
2013,9,FIRE-ARMS,2,2,1,0,6,MAHARASHTRA,7
2013,11584,SUDDEN DEATHS(HEART ATTACKS),4281,2549,1001,1732,6282,MAHARASHTRA,7283
2013,1993,EPILEPTIC FITS/GIDDINESS,316,217,379,99,1299,MAHARASHTRA,1678
2013,546,ABORTIONS/CHILD BIRTH,51,0,502,51,0,MAHARASHTRA,502
2013,1847,INFLUENCE OF ALCOHOL,353,352,16,1,1478,MAHARASHTRA,1494
2013,2658,FOOD POISIONING/ACCIDENTAL INTAKE OF INSECTICIDES ETC.,1759,952,266,807,684,MAHARASHTRA,950
2013,5620,SNAKE BITE/ANIMAL BITE,4641,2570,370,2071,613,MAHARASHTRA,983
2013,707,OTHER,423,263,86,160,205,MAHARASHTRA,291
2013,8165,OTHER RAILWAY ACCIDENTS,3185,2734,509,451,4477,MAHARASHTRA,4986
2013,23828,OTHER,7494,5294,3799,2200,12745,MAHARASHTRA,16544
2013,4874,TOTAL DROWNING,189,132,1155,57,3674,MAHARASHTRA,4829
2013,2651,TOTAL FALLS,587,460,305,127,1770,MAHARASHTRA,2075
2013,5894,TOTAL FIRE,1656,516,3099,1140,1219,MAHARASHTRA,4318
2013,15970,TOTAL SUDDEN DEATHS,5001,3118,1898,1883,9059,MAHARASHTRA,10957
2013,9050,TOTAL POISONING,6830,3792,750,3038,1533,MAHARASHTRA,2283
2013,13,ELECTROCUTION,0,0,1,0,12,MANIPUR,13
2013,0,GAS CYLINDER/STOVE BURST,0,0,0,0,0,MANIPUR,0
2013,6,FIRE-ARMS,0,0,1,0,5,MANIPUR,6
2013,5,SUDDEN DEATHS(HEART ATTACKS),0,0,1,0,4,MANIPUR,5
2013,0,EPILEPTIC FITS/GIDDINESS,0,0,0,0,0,MANIPUR,0
2013,2,ABORTIONS/CHILD BIRTH,0,0,2,0,0,MANIPUR,2
2013,0,INFLUENCE OF ALCOHOL,0,0,0,0,0,MANIPUR,0
2013,2,FOOD POISIONING/ACCIDENTAL INTAKE OF INSECTICIDES ETC.,0,0,2,0,0,MANIPUR,2
2013,0,SNAKE BITE/ANIMAL BITE,0,0,0,0,0,MANIPUR,0
2013,4,OTHER,0,0,3,0,1,MANIPUR,4
2013,0,OTHER RAILWAY ACCIDENTS,0,0,0,0,0,MANIPUR,0
2013,33,OTHER,0,0,8,0,25,MANIPUR,33
2013,12,TOTAL DROWNING,0,0,2,0,10,MANIPUR,12
2013,11,TOTAL FALLS,0,0,0,0,12,MANIPUR,12
2013,2,TOTAL FIRE,0,0,2,0,0,MANIPUR,2
2013,7,TOTAL SUDDEN DEATHS,0,0,3,0,4,MANIPUR,7
2013,6,TOTAL POISONING,0,0,5,0,1,MANIPUR,6
2013,11,ELECTROCUTION,0,0,6,0,11,MEGHALAYA,17
2013,4,GAS CYLINDER/STOVE BURST,0,0,4,0,0,MEGHALAYA,4
2013,1,FIRE-ARMS,0,0,0,0,1,MEGHALAYA,1
2013,22,SUDDEN DEATHS(HEART ATTACKS),0,0,5,0,17,MEGHALAYA,22
2013,2,EPILEPTIC FITS/GIDDINESS,0,0,0,0,2,MEGHALAYA,2
2013,4,ABORTIONS/CHILD BIRTH,0,0,4,0,0,MEGHALAYA,4
2013,6,INFLUENCE OF ALCOHOL,0,0,0,0,6,MEGHALAYA,6
2013,0,FOOD POISIONING/ACCIDENTAL INTAKE OF INSECTICIDES ETC.,0,0,0,0,0,MEGHALAYA,0
2013,0,SNAKE BITE/ANIMAL BITE,0,0,0,0,0,MEGHALAYA,0
2013,0,OTHER,0,0,0,0,0,MEGHALAYA,0
2013,0,OTHER RAILWAY ACCIDENTS,0,0,0,0,0,MEGHALAYA,0
2013,30,OTHER,0,0,11,0,28,MEGHALAYA,39
2013,47,TOTAL DROWNING,3,3,7,0,37,MEGHALAYA,44
2013,18,TOTAL FALLS,0,0,3,0,15,MEGHALAYA,18
2013,16,TOTAL FIRE,0,0,6,0,10,MEGHALAYA,16
2013,34,TOTAL SUDDEN DEATHS,0,0,9,0,25,MEGHALAYA,34
2013,1,TOTAL POISONING,0,0,0,0,4,MEGHALAYA,4
2013,5,ELECTROCUTION,0,0,0,0,5,MIZORAM,5
2013,0,GAS CYLINDER/STOVE BURST,0,0,0,0,0,MIZORAM,0
2013,2,FIRE-ARMS,0,0,0,0,2,MIZORAM,2
2013,5,SUDDEN DEATHS(HEART ATTACKS),0,0,0,0,5,MIZORAM,5
2013,0,EPILEPTIC FITS/GIDDINESS,0,0,0,0,0,MIZORAM,0
2013,0,ABORTIONS/CHILD BIRTH,0,0,0,0,0,MIZORAM,0
2013,2,INFLUENCE OF ALCOHOL,0,0,0,0,2,MIZORAM,2
2013,1,FOOD POISIONING/ACCIDENTAL INTAKE OF INSECTICIDES ETC.,0,0,0,0,1,MIZORAM,1
2013,0,SNAKE BITE/ANIMAL BITE,0,0,0,0,0,MIZORAM,0
2013,0,OTHER,0,0,0,0,0,MIZORAM,0
2013,0,OTHER RAILWAY ACCIDENTS,0,0,0,0,0,MIZORAM,0
2013,24,OTHER,0,0,6,0,21,MIZORAM,27
2013,35,TOTAL DROWNING,0,0,3,0,34,MIZORAM,37
2013,16,TOTAL FALLS,0,0,1,0,15,MIZORAM,16
2013,2,TOTAL FIRE,0,0,1,0,1,MIZORAM,2
2013,7,TOTAL SUDDEN DEATHS,0,0,0,0,7,MIZORAM,7
2013,1,TOTAL POISONING,0,0,0,0,1,MIZORAM,1
2013,2,ELECTROCUTION,0,0,0,0,3,NAGALAND,3
2013,0,GAS CYLINDER/STOVE BURST,0,0,0,0,0,NAGALAND,0
2013,1,FIRE-ARMS,0,0,0,0,1,NAGALAND,1
2013,1,SUDDEN DEATHS(HEART ATTACKS),0,0,0,0,1,NAGALAND,1
2013,0,EPILEPTIC FITS/GIDDINESS,0,0,0,0,0,NAGALAND,0
2013,0,ABORTIONS/CHILD BIRTH,0,0,0,0,0,NAGALAND,0
2013,0,INFLUENCE OF ALCOHOL,0,0,0,0,0,NAGALAND,0
2013,0,FOOD POISIONING/ACCIDENTAL INTAKE OF INSECTICIDES ETC.,0,0,0,0,0,NAGALAND,0
2013,0,SNAKE BITE/ANIMAL BITE,0,0,0,0,0,NAGALAND,0
2013,0,OTHER,0,0,0,0,0,NAGALAND,0
2013,5,OTHER RAILWAY ACCIDENTS,0,0,0,0,5,NAGALAND,5
2013,0,OTHER,0,0,0,0,0,NAGALAND,0
2013,5,TOTAL DROWNING,0,0,1,0,5,NAGALAND,6
2013,3,TOTAL FALLS,0,0,0,0,3,NAGALAND,3
2013,0,TOTAL FIRE,0,0,0,0,0,NAGALAND,0
2013,1,TOTAL SUDDEN DEATHS,0,0,0,0,1,NAGALAND,1
2013,0,TOTAL POISONING,0,0,0,0,0,NAGALAND,0
2013,180,ELECTROCUTION,0,0,25,0,156,ODISHA,181
2013,26,GAS CYLINDER/STOVE BURST,0,0,17,0,11,ODISHA,28
2013,0,FIRE-ARMS,0,0,0,0,0,ODISHA,0
2013,147,SUDDEN DEATHS(HEART ATTACKS),0,0,28,0,122,ODISHA,150
2013,79,EPILEPTIC FITS/GIDDINESS,0,0,30,0,49,ODISHA,79
2013,8,ABORTIONS/CHILD BIRTH,0,0,8,0,0,ODISHA,8
2013,20,INFLUENCE OF ALCOHOL,0,0,0,0,20,ODISHA,20
2013,139,FOOD POISIONING/ACCIDENTAL INTAKE OF INSECTICIDES ETC.,7,5,50,2,91,ODISHA,141
2013,516,SNAKE BITE/ANIMAL BITE,7,3,189,4,329,ODISHA,518
2013,1068,OTHER,0,0,360,0,708,ODISHA,1068
2013,245,OTHER RAILWAY ACCIDENTS,0,0,49,0,209,ODISHA,258
2013,966,OTHER,0,0,310,0,657,ODISHA,967
2013,701,TOTAL DROWNING,35,24,197,11,520,ODISHA,717
2013,524,TOTAL FALLS,2,1,102,1,423,ODISHA,525
2013,569,TOTAL FIRE,1,1,268,0,307,ODISHA,575
2013,254,TOTAL SUDDEN DEATHS,0,0,66,0,191,ODISHA,257
2013,1741,TOTAL POISONING,14,8,602,6,1143,ODISHA,1745
2013,265,ELECTROCUTION,6,6,20,0,248,PUNJAB,268
2013,129,GAS CYLINDER/STOVE BURST,10,4,104,6,33,PUNJAB,137
2013,30,FIRE-ARMS,4,4,4,0,26,PUNJAB,30
2013,666,SUDDEN DEATHS(HEART ATTACKS),0,0,62,0,604,PUNJAB,666
2013,126,EPILEPTIC FITS/GIDDINESS,0,0,16,0,110,PUNJAB,126
2013,6,ABORTIONS/CHILD BIRTH,0,0,6,0,0,PUNJAB,6
2013,235,INFLUENCE OF ALCOHOL,0,0,1,0,234,PUNJAB,235
2013,366,FOOD POISIONING/ACCIDENTAL INTAKE OF INSECTICIDES ETC.,0,0,110,0,257,PUNJAB,367
2013,63,SNAKE BITE/ANIMAL BITE,0,0,10,0,53,PUNJAB,63
2013,407,OTHER,6,4,85,2,319,PUNJAB,404
2013,967,OTHER RAILWAY ACCIDENTS,0,0,98,0,869,PUNJAB,967
2013,641,OTHER,5,4,88,1,555,PUNJAB,643
2013,559,TOTAL DROWNING,4,4,75,0,484,PUNJAB,559
2013,233,TOTAL FALLS,3,3,22,0,210,PUNJAB,232
2013,347,TOTAL FIRE,24,17,196,7,170,PUNJAB,366
2013,1033,TOTAL SUDDEN DEATHS,0,0,85,0,948,PUNJAB,1033
2013,883,TOTAL POISONING,6,4,211,2,670,PUNJAB,881
2013,889,ELECTROCUTION,11,8,130,3,764,RAJASTHAN,894
2013,190,GAS CYLINDER/STOVE BURST,5,3,150,2,43,RAJASTHAN,193
2013,7,FIRE-ARMS,0,0,0,0,7,RAJASTHAN,7
2013,667,SUDDEN DEATHS(HEART ATTACKS),0,0,98,0,569,RAJASTHAN,667
2013,154,EPILEPTIC FITS/GIDDINESS,0,0,38,0,116,RAJASTHAN,154
2013,18,ABORTIONS/CHILD BIRTH,0,0,18,0,0,RAJASTHAN,18
2013,274,INFLUENCE OF ALCOHOL,0,0,6,0,270,RAJASTHAN,276
2013,648,FOOD POISIONING/ACCIDENTAL INTAKE OF INSECTICIDES ETC.,2,2,231,0,426,RAJASTHAN,657
2013,561,SNAKE BITE/ANIMAL BITE,0,0,203,0,361,RAJASTHAN,564
2013,465,OTHER,0,0,134,0,337,RAJASTHAN,471
2013,300,OTHER RAILWAY ACCIDENTS,0,0,44,0,261,RAJASTHAN,305
2013,2813,OTHER,0,0,700,0,2126,RAJASTHAN,2826
2013,1575,TOTAL DROWNING,5,3,394,2,1248,RAJASTHAN,1642
2013,772,TOTAL FALLS,2,2,119,0,657,RAJASTHAN,776
2013,893,TOTAL FIRE,18,12,524,6,384,RAJASTHAN,908
2013,1113,TOTAL SUDDEN DEATHS,0,0,160,0,955,RAJASTHAN,1115
2013,1674,TOTAL POISONING,2,2,568,0,1124,RAJASTHAN,1692
2013,2,ELECTROCUTION,0,0,0,0,2,SIKKIM,2
2013,0,GAS CYLINDER/STOVE BURST,0,0,0,0,0,SIKKIM,0
2013,0,FIRE-ARMS,0,0,0,0,0,SIKKIM,0
2013,5,SUDDEN DEATHS(HEART ATTACKS),0,0,1,0,4,SIKKIM,5
2013,0,EPILEPTIC FITS/GIDDINESS,0,0,0,0,0,SIKKIM,0
2013,0,ABORTIONS/CHILD BIRTH,0,0,0,0,0,SIKKIM,0
2013,14,INFLUENCE OF ALCOHOL,0,0,1,0,13,SIKKIM,14
2013,0,FOOD POISIONING/ACCIDENTAL INTAKE OF INSECTICIDES ETC.,0,0,0,0,0,SIKKIM,0
2013,0,SNAKE BITE/ANIMAL BITE,0,0,0,0,0,SIKKIM,0
2013,0,OTHER,0,0,0,0,0,SIKKIM,0
2013,0,OTHER RAILWAY ACCIDENTS,0,0,0,0,0,SIKKIM,0
2013,31,OTHER,0,0,6,0,25,SIKKIM,31
2013,39,TOTAL DROWNING,0,0,8,0,31,SIKKIM,39
2013,58,TOTAL FALLS,0,0,12,0,46,SIKKIM,58
2013,10,TOTAL FIRE,0,0,6,0,4,SIKKIM,10
2013,19,TOTAL SUDDEN DEATHS,0,0,2,0,17,SIKKIM,19
2013,0,TOTAL POISONING,0,0,0,0,0,SIKKIM,0
2013,519,ELECTROCUTION,0,0,66,0,460,TAMIL NADU,526
2013,623,GAS CYLINDER/STOVE BURST,45,6,452,39,144,TAMIL NADU,596
2013,0,FIRE-ARMS,0,0,0,0,0,TAMIL NADU,0
2013,1492,SUDDEN DEATHS(HEART ATTACKS),0,0,171,0,1322,TAMIL NADU,1493
2013,705,EPILEPTIC FITS/GIDDINESS,0,0,151,0,554,TAMIL NADU,705
2013,45,ABORTIONS/CHILD BIRTH,0,0,45,0,0,TAMIL NADU,45
2013,432,INFLUENCE OF ALCOHOL,0,0,7,0,425,TAMIL NADU,432
2013,210,FOOD POISIONING/ACCIDENTAL INTAKE OF INSECTICIDES ETC.,0,0,58,0,153,TAMIL NADU,211
2013,610,SNAKE BITE/ANIMAL BITE,0,0,226,0,384,TAMIL NADU,610
2013,1876,OTHER,0,0,553,0,1336,TAMIL NADU,1889
2013,1978,OTHER RAILWAY ACCIDENTS,63,60,277,3,1694,TAMIL NADU,1971
2013,3517,OTHER,4,3,1137,1,2404,TAMIL NADU,3541
2013,1679,TOTAL DROWNING,13,10,296,3,1421,TAMIL NADU,1717
2013,977,TOTAL FALLS,16,14,124,2,845,TAMIL NADU,969
2013,2001,TOTAL FIRE,96,42,1211,54,758,TAMIL NADU,1969
2013,2674,TOTAL SUDDEN DEATHS,0,0,374,0,2301,TAMIL NADU,2675
2013,2700,TOTAL POISONING,0,0,837,0,1877,TAMIL NADU,2714
2013,21,ELECTROCUTION,0,0,4,0,17,TRIPURA,21
2013,0,GAS CYLINDER/STOVE BURST,0,0,0,0,0,TRIPURA,0
2013,1,FIRE-ARMS,0,0,0,0,1,TRIPURA,1
2013,50,SUDDEN DEATHS(HEART ATTACKS),0,0,11,0,39,TRIPURA,50
2013,16,EPILEPTIC FITS/GIDDINESS,0,0,3,0,13,TRIPURA,16
2013,2,ABORTIONS/CHILD BIRTH,0,0,2,0,0,TRIPURA,2
2013,7,INFLUENCE OF ALCOHOL,0,0,0,0,7,TRIPURA,7
2013,0,FOOD POISIONING/ACCIDENTAL INTAKE OF INSECTICIDES ETC.,0,0,0,0,0,TRIPURA,0
2013,1,SNAKE BITE/ANIMAL BITE,0,0,1,0,0,TRIPURA,1
2013,23,OTHER,0,0,10,0,13,TRIPURA,23
2013,0,OTHER RAILWAY ACCIDENTS,0,0,0,0,0,TRIPURA,0
2013,64,OTHER,0,0,19,0,48,TRIPURA,67
2013,63,TOTAL DROWNING,0,0,22,0,41,TRIPURA,63
2013,11,TOTAL FALLS,0,0,3,0,8,TRIPURA,11
2013,35,TOTAL FIRE,0,0,23,0,12,TRIPURA,35
2013,75,TOTAL SUDDEN DEATHS,0,0,16,0,59,TRIPURA,75
2013,34,TOTAL POISONING,0,0,16,0,18,TRIPURA,34
2013,639,ELECTROCUTION,68,59,80,9,539,UTTAR PRADESH,619
2013,124,GAS CYLINDER/STOVE BURST,25,8,99,17,34,UTTAR PRADESH,133
2013,832,FIRE-ARMS,306,265,125,41,595,UTTAR PRADESH,720
2013,384,SUDDEN DEATHS(HEART ATTACKS),19,14,69,5,306,UTTAR PRADESH,375
2013,56,EPILEPTIC FITS/GIDDINESS,5,4,10,1,50,UTTAR PRADESH,60
2013,77,ABORTIONS/CHILD BIRTH,4,0,67,4,0,UTTAR PRADESH,67
2013,245,INFLUENCE OF ALCOHOL,23,23,5,0,228,UTTAR PRADESH,233
2013,563,FOOD POISIONING/ACCIDENTAL INTAKE OF INSECTICIDES ETC.,42,30,236,12,333,UTTAR PRADESH,569
2013,208,SNAKE BITE/ANIMAL BITE,22,16,50,6,143,UTTAR PRADESH,193
2013,392,OTHER,66,47,133,19,250,UTTAR PRADESH,383
2013,3341,OTHER RAILWAY ACCIDENTS,237,200,536,37,2831,UTTAR PRADESH,3367
2013,1591,OTHER,349,242,381,107,1253,UTTAR PRADESH,1634
2013,1301,TOTAL DROWNING,139,112,269,27,1062,UTTAR PRADESH,1331
2013,470,TOTAL FALLS,46,37,58,9,379,UTTAR PRADESH,437
2013,1327,TOTAL FIRE,181,87,897,94,437,UTTAR PRADESH,1334
2013,762,TOTAL SUDDEN DEATHS,51,41,151,10,584,UTTAR PRADESH,735
2013,1299,TOTAL POISONING,146,102,446,44,829,UTTAR PRADESH,1275
2013,39,ELECTROCUTION,22,22,9,0,54,UTTARAKHAND,63
2013,11,GAS CYLINDER/STOVE BURST,0,0,5,0,6,UTTARAKHAND,11
2013,8,FIRE-ARMS,2,2,1,0,5,UTTARAKHAND,6
2013,168,SUDDEN DEATHS(HEART ATTACKS),5,5,23,0,142,UTTARAKHAND,165
2013,8,EPILEPTIC FITS/GIDDINESS,0,0,3,0,5,UTTARAKHAND,8
2013,3,ABORTIONS/CHILD BIRTH,0,0,3,0,0,UTTARAKHAND,3
2013,38,INFLUENCE OF ALCOHOL,0,0,0,0,42,UTTARAKHAND,42
2013,96,FOOD POISIONING/ACCIDENTAL INTAKE OF INSECTICIDES ETC.,4,3,35,1,70,UTTARAKHAND,105
2013,2,SNAKE BITE/ANIMAL BITE,0,0,1,0,1,UTTARAKHAND,2
2013,112,OTHER,4,4,51,0,64,UTTARAKHAND,115
2013,67,OTHER RAILWAY ACCIDENTS,8,5,7,3,52,UTTARAKHAND,59
2013,403,OTHER,41,34,90,7,298,UTTARAKHAND,388
2013,132,TOTAL DROWNING,24,20,28,4,118,UTTARAKHAND,146
2013,78,TOTAL FALLS,13,9,12,4,68,UTTARAKHAND,80
2013,107,TOTAL FIRE,1,1,68,0,48,UTTARAKHAND,116
2013,217,TOTAL SUDDEN DEATHS,5,5,29,0,189,UTTARAKHAND,218
2013,210,TOTAL POISONING,8,7,87,1,135,UTTARAKHAND,222
2013,172,ELECTROCUTION,13,11,37,2,140,WEST BENGAL,177
2013,60,GAS CYLINDER/STOVE BURST,16,4,52,12,14,WEST BENGAL,66
2013,56,FIRE-ARMS,24,20,1,4,38,WEST BENGAL,39
2013,469,SUDDEN DEATHS(HEART ATTACKS),118,86,101,32,342,WEST BENGAL,443
2013,13,EPILEPTIC FITS/GIDDINESS,7,7,4,0,7,WEST BENGAL,11
2013,33,ABORTIONS/CHILD BIRTH,14,0,15,14,0,WEST BENGAL,15
2013,23,INFLUENCE OF ALCOHOL,2,2,1,0,22,WEST BENGAL,23
2013,294,FOOD POISIONING/ACCIDENTAL INTAKE OF INSECTICIDES ETC.,47,18,137,29,182,WEST BENGAL,319
2013,512,SNAKE BITE/ANIMAL BITE,44,25,313,19,382,WEST BENGAL,695
2013,2066,OTHER,220,179,942,41,1810,WEST BENGAL,2752
2013,2784,OTHER RAILWAY ACCIDENTS,55,37,565,18,2218,WEST BENGAL,2783
2013,2308,OTHER,21,20,690,1,1597,WEST BENGAL,2287
2013,820,TOTAL DROWNING,82,58,214,24,645,WEST BENGAL,859
2013,176,TOTAL FALLS,45,35,19,10,146,WEST BENGAL,165
2013,992,TOTAL FIRE,122,66,799,56,271,WEST BENGAL,1070
2013,538,TOTAL SUDDEN DEATHS,141,95,121,46,371,WEST BENGAL,492
2013,2876,TOTAL POISONING,311,222,1393,89,2383,WEST BENGAL,3776
2013,5,ELECTROCUTION,0,0,2,0,4,A & N ISLANDS,6
2013,0,GAS CYLINDER/STOVE BURST,0,0,0,0,0,A & N ISLANDS,0
2013,0,FIRE-ARMS,0,0,0,0,0,A & N ISLANDS,0
2013,31,SUDDEN DEATHS(HEART ATTACKS),0,0,4,0,27,A & N ISLANDS,31
2013,4,EPILEPTIC FITS/GIDDINESS,0,0,0,0,4,A & N ISLANDS,4
2013,0,ABORTIONS/CHILD BIRTH,0,0,0,0,0,A & N ISLANDS,0
2013,0,INFLUENCE OF ALCOHOL,0,0,0,0,0,A & N ISLANDS,0
2013,5,FOOD POISIONING/ACCIDENTAL INTAKE OF INSECTICIDES ETC.,0,0,3,0,3,A & N ISLANDS,6
2013,1,SNAKE BITE/ANIMAL BITE,0,0,0,0,1,A & N ISLANDS,1
2013,0,OTHER,0,0,0,0,0,A & N ISLANDS,0
2013,0,OTHER RAILWAY ACCIDENTS,0,0,0,0,0,A & N ISLANDS,0
2013,87,OTHER,0,0,17,0,70,A & N ISLANDS,87
2013,43,TOTAL DROWNING,0,0,7,0,39,A & N ISLANDS,46
2013,8,TOTAL FALLS,0,0,2,0,6,A & N ISLANDS,8
2013,7,TOTAL FIRE,0,0,6,0,1,A & N ISLANDS,7
2013,35,TOTAL SUDDEN DEATHS,0,0,4,0,31,A & N ISLANDS,35
2013,6,TOTAL POISONING,0,0,3,0,4,A & N ISLANDS,7
2013,2,ELECTROCUTION,0,0,0,0,2,CHANDIGARH,2
2013,4,GAS CYLINDER/STOVE BURST,0,0,3,0,1,CHANDIGARH,4
2013,0,FIRE-ARMS,0,0,0,0,0,CHANDIGARH,0
2013,47,SUDDEN DEATHS(HEART ATTACKS),0,0,4,0,43,CHANDIGARH,47
2013,4,EPILEPTIC FITS/GIDDINESS,0,0,0,0,4,CHANDIGARH,4
2013,4,ABORTIONS/CHILD BIRTH,0,0,4,0,0,CHANDIGARH,4
2013,20,INFLUENCE OF ALCOHOL,0,0,0,0,20,CHANDIGARH,20
2013,2,FOOD POISIONING/ACCIDENTAL INTAKE OF INSECTICIDES ETC.,0,0,1,0,1,CHANDIGARH,2
2013,1,SNAKE BITE/ANIMAL BITE,0,0,1,0,0,CHANDIGARH,1
2013,7,OTHER,0,0,2,0,5,CHANDIGARH,7
2013,0,OTHER RAILWAY ACCIDENTS,0,0,0,0,0,CHANDIGARH,0
2013,67,OTHER,0,0,14,0,53,CHANDIGARH,67
2013,1,TOTAL DROWNING,0,0,0,0,1,CHANDIGARH,1
2013,32,TOTAL FALLS,0,0,5,0,27,CHANDIGARH,32
2013,20,TOTAL FIRE,0,0,14,0,6,CHANDIGARH,20
2013,75,TOTAL SUDDEN DEATHS,0,0,8,0,67,CHANDIGARH,75
2013,14,TOTAL POISONING,0,0,6,0,8,CHANDIGARH,14
2013,3,ELECTROCUTION,0,0,0,0,3,D & N HAVELI,3
2013,11,GAS CYLINDER/STOVE BURST,0,0,7,0,4,D & N HAVELI,11
2013,0,FIRE-ARMS,0,0,0,0,0,D & N HAVELI,0
2013,3,SUDDEN DEATHS(HEART ATTACKS),0,0,0,0,3,D & N HAVELI,3
2013,0,EPILEPTIC FITS/GIDDINESS,0,0,0,0,0,D & N HAVELI,0
2013,1,ABORTIONS/CHILD BIRTH,0,0,1,0,0,D & N HAVELI,1
2013,0,INFLUENCE OF ALCOHOL,0,0,0,0,0,D & N HAVELI,0
2013,3,FOOD POISIONING/ACCIDENTAL INTAKE OF INSECTICIDES ETC.,0,0,2,0,1,D & N HAVELI,3
2013,1,SNAKE BITE/ANIMAL BITE,0,0,0,0,1,D & N HAVELI,1
2013,1,OTHER,0,0,0,0,1,D & N HAVELI,1
2013,0,OTHER RAILWAY ACCIDENTS,0,0,0,0,0,D & N HAVELI,0
2013,0,OTHER,0,0,0,0,0,D & N HAVELI,0
2013,13,TOTAL DROWNING,0,0,3,0,10,D & N HAVELI,13
2013,8,TOTAL FALLS,0,0,1,0,7,D & N HAVELI,8
2013,12,TOTAL FIRE,0,0,8,0,4,D & N HAVELI,12
2013,4,TOTAL SUDDEN DEATHS,0,0,1,0,3,D & N HAVELI,4
2013,5,TOTAL POISONING,0,0,2,0,3,D & N HAVELI,5
2013,4,ELECTROCUTION,0,0,0,0,4,DAMAN & DIU,4
2013,14,GAS CYLINDER/STOVE BURST,0,0,9,0,5,DAMAN & DIU,14
2013,0,FIRE-ARMS,0,0,0,0,0,DAMAN & DIU,0
2013,8,SUDDEN DEATHS(HEART ATTACKS),0,0,0,0,8,DAMAN & DIU,8
2013,3,EPILEPTIC FITS/GIDDINESS,0,0,0,0,3,DAMAN & DIU,3
2013,3,ABORTIONS/CHILD BIRTH,0,0,2,0,0,DAMAN & DIU,2
2013,2,INFLUENCE OF ALCOHOL,0,0,0,0,1,DAMAN & DIU,1
2013,0,FOOD POISIONING/ACCIDENTAL INTAKE OF INSECTICIDES ETC.,0,0,0,0,0,DAMAN & DIU,0
2013,0,SNAKE BITE/ANIMAL BITE,0,0,0,0,0,DAMAN & DIU,0
2013,0,OTHER,0,0,0,0,0,DAMAN & DIU,0
2013,0,OTHER RAILWAY ACCIDENTS,0,0,0,0,0,DAMAN & DIU,0
2013,45,OTHER,0,0,9,0,36,DAMAN & DIU,45
2013,26,TOTAL DROWNING,0,0,1,0,25,DAMAN & DIU,26
2013,5,TOTAL FALLS,0,0,2,0,4,DAMAN & DIU,6
2013,16,TOTAL FIRE,0,0,10,0,6,DAMAN & DIU,16
2013,16,TOTAL SUDDEN DEATHS,0,0,2,0,12,DAMAN & DIU,14
2013,3,TOTAL POISONING,0,0,0,0,3,DAMAN & DIU,3
2013,125,ELECTROCUTION,18,17,13,1,106,DELHI(UT),119
2013,41,GAS CYLINDER/STOVE BURST,21,15,29,6,6,DELHI(UT),35
2013,43,FIRE-ARMS,28,25,2,3,19,DELHI(UT),21
2013,220,SUDDEN DEATHS(HEART ATTACKS),0,0,33,0,187,DELHI(UT),220
2013,3,EPILEPTIC FITS/GIDDINESS,0,0,1,0,2,DELHI(UT),3
2013,11,ABORTIONS/CHILD BIRTH,0,0,11,0,0,DELHI(UT),11
2013,65,INFLUENCE OF ALCOHOL,0,0,0,0,65,DELHI(UT),65
2013,52,FOOD POISIONING/ACCIDENTAL INTAKE OF INSECTICIDES ETC.,0,0,18,0,35,DELHI(UT),53
2013,18,SNAKE BITE/ANIMAL BITE,7,5,3,2,9,DELHI(UT),12
2013,68,OTHER,15,15,18,0,36,DELHI(UT),54
2013,1285,OTHER RAILWAY ACCIDENTS,359,325,100,34,826,DELHI(UT),926
2013,1568,OTHER,240,214,293,26,1081,DELHI(UT),1374
2013,159,TOTAL DROWNING,1,1,18,0,154,DELHI(UT),172
2013,423,TOTAL FALLS,72,62,68,10,313,DELHI(UT),381
2013,192,TOTAL FIRE,78,65,82,13,120,DELHI(UT),202
2013,299,TOTAL SUDDEN DEATHS,0,0,45,0,254,DELHI(UT),299
2013,144,TOTAL POISONING,23,21,40,2,84,DELHI(UT),124
2013,0,ELECTROCUTION,0,0,0,0,0,LAKSHADWEEP,0
2013,0,GAS CYLINDER/STOVE BURST,0,0,0,0,0,LAKSHADWEEP,0
2013,0,FIRE-ARMS,0,0,0,0,0,LAKSHADWEEP,0
2013,1,SUDDEN DEATHS(HEART ATTACKS),1,1,0,0,1,LAKSHADWEEP,1
2013,1,EPILEPTIC FITS/GIDDINESS,1,1,0,0,1,LAKSHADWEEP,1
2013,0,ABORTIONS/CHILD BIRTH,0,0,0,0,0,LAKSHADWEEP,0
2013,0,INFLUENCE OF ALCOHOL,0,0,0,0,0,LAKSHADWEEP,0
2013,0,FOOD POISIONING/ACCIDENTAL INTAKE OF INSECTICIDES ETC.,0,0,0,0,0,LAKSHADWEEP,0
2013,0,SNAKE BITE/ANIMAL BITE,0,0,0,0,0,LAKSHADWEEP,0
2013,0,OTHER,0,0,0,0,0,LAKSHADWEEP,0
2013,0,OTHER RAILWAY ACCIDENTS,0,0,0,0,0,LAKSHADWEEP,0
2013,0,OTHER,0,0,0,0,0,LAKSHADWEEP,0
2013,1,TOTAL DROWNING,1,1,0,0,1,LAKSHADWEEP,1
2013,0,TOTAL FALLS,0,0,0,0,0,LAKSHADWEEP,0
2013,0,TOTAL FIRE,0,0,0,0,0,LAKSHADWEEP,0
2013,2,TOTAL SUDDEN DEATHS,2,2,0,0,2,LAKSHADWEEP,2
2013,0,TOTAL POISONING,0,0,0,0,0,LAKSHADWEEP,0
2013,29,ELECTROCUTION,4,4,3,0,22,PUDUCHERRY,25
2013,5,GAS CYLINDER/STOVE BURST,0,0,5,0,0,PUDUCHERRY,5
2013,0,FIRE-ARMS,0,0,0,0,0,PUDUCHERRY,0
2013,71,SUDDEN DEATHS(HEART ATTACKS),0,0,5,0,66,PUDUCHERRY,71
2013,258,EPILEPTIC FITS/GIDDINESS,0,0,41,0,217,PUDUCHERRY,258
2013,1,ABORTIONS/CHILD BIRTH,0,0,1,0,0,PUDUCHERRY,1
2013,226,INFLUENCE OF ALCOHOL,0,0,6,0,220,PUDUCHERRY,226
2013,10,FOOD POISIONING/ACCIDENTAL INTAKE OF INSECTICIDES ETC.,0,0,6,0,4,PUDUCHERRY,10
2013,8,SNAKE BITE/ANIMAL BITE,0,0,3,0,5,PUDUCHERRY,8
2013,1,OTHER,0,0,0,0,1,PUDUCHERRY,1
2013,11,OTHER RAILWAY ACCIDENTS,0,0,4,0,7,PUDUCHERRY,11
2013,18,OTHER,5,5,0,0,13,PUDUCHERRY,13
2013,101,TOTAL DROWNING,0,0,9,0,95,PUDUCHERRY,104
2013,56,TOTAL FALLS,1,1,7,0,48,PUDUCHERRY,55
2013,16,TOTAL FIRE,2,2,10,0,4,PUDUCHERRY,14
2013,556,TOTAL SUDDEN DEATHS,0,0,53,0,503,PUDUCHERRY,556
2013,20,TOTAL POISONING,3,3,9,0,12,PUDUCHERRY,21
