MALE KILLED,CASES,MALE INJURED,YEAR,STATE/UT,TOTAL KILLED,FEMALE INJURED,FEMALE KILLED,INJURED,CAUSE
745,875,13,2003,ANDHRA PRADESH,849,0,104,13,ELECTROCUTION
165,846,24,2003,ANDHRA PRADESH,818,73,653,97,GAS CYLINDER/STOVE BURST
4,4,0,2003,ANDHRA PRADESH,4,0,0,0,FIRE-ARMS
295,383,0,2003,ANDHRA PRADESH,383,0,88,0,SUDDEN DEATHS(HEART ATTACKS)
66,94,1,2003,ANDHRA PRADESH,94,0,28,1,EPILEPTIC FITS/GIDDINESS
0,13,0,2003,ANDHRA PRADESH,13,0,13,0,ABORTIONS/CHILD BIRTH
321,337,5,2003,ANDHRA PRADESH,337,0,16,5,INFLUENCE OF ALCOHOL
246,344,7,2003,ANDHRA PRADESH,348,8,102,15,FOOD POISIONING/ACCIDENTAL INTAKE OF INSECTICIDES ETC.
542,711,5,2003,ANDHRA PRADESH,725,2,183,7,SNAKE BITE/ANIMAL BITE
928,1160,0,2003,ANDHRA PRADESH,1267,1,339,1,OTHER
417,490,1,2003,ANDHRA PRADESH,489,0,72,1,OTHER RAILWAY ACCIDENTS
755,1007,7,2003,ANDHRA PRADESH,989,3,234,10,OTHER
1272,1588,16,2003,ANDHRA PRADESH,1671,6,399,22,DROWNING
931,1094,13,2003,ANDHRA PRADESH,1105,2,174,15,FALLS
691,1956,40,2003,ANDHRA PRADESH,1956,92,1265,132,FIRE
682,827,6,2003,ANDHRA PRADESH,827,0,145,6,SUDDEN DEATHS
1803,2339,14,2003,ANDHRA PRADESH,2465,11,662,25,POISONING
4,4,0,2003,ARUNACHAL PRADESH,4,0,0,0,ELECTROCUTION
0,0,0,2003,ARUNACHAL PRADESH,0,0,0,0,GAS CYLINDER/STOVE BURST
0,0,0,2003,ARUNACHAL PRADESH,0,0,0,0,FIRE-ARMS
7,7,0,2003,ARUNACHAL PRADESH,7,0,0,0,SUDDEN DEATHS(HEART ATTACKS)
1,1,0,2003,ARUNACHAL PRADESH,1,0,0,0,EPILEPTIC FITS/GIDDINESS
0,0,0,2003,ARUNACHAL PRADESH,0,0,0,0,ABORTIONS/CHILD BIRTH
4,6,0,2003,ARUNACHAL PRADESH,6,0,2,0,INFLUENCE OF ALCOHOL
0,3,0,2003,ARUNACHAL PRADESH,3,0,3,0,FOOD POISIONING/ACCIDENTAL INTAKE OF INSECTICIDES ETC.
0,0,0,2003,ARUNACHAL PRADESH,0,0,0,0,SNAKE BITE/ANIMAL BITE
13,18,0,2003,ARUNACHAL PRADESH,19,0,6,0,OTHER
0,0,0,2003,ARUNACHAL PRADESH,0,0,0,0,OTHER RAILWAY ACCIDENTS
0,0,0,2003,ARUNACHAL PRADESH,0,0,0,0,OTHER
13,19,0,2003,ARUNACHAL PRADESH,19,0,6,0,DROWNING
17,16,0,2003,ARUNACHAL PRADESH,17,0,0,0,FALLS
6,8,0,2003,ARUNACHAL PRADESH,10,0,4,0,FIRE
12,14,0,2003,ARUNACHAL PRADESH,14,0,2,0,SUDDEN DEATHS
13,21,0,2003,ARUNACHAL PRADESH,22,0,9,0,POISONING
42,49,1,2003,ASSAM,48,0,6,1,ELECTROCUTION
1,6,0,2003,ASSAM,6,0,5,0,GAS CYLINDER/STOVE BURST
23,24,0,2003,ASSAM,26,0,3,0,FIRE-ARMS
55,62,0,2003,ASSAM,66,0,11,0,SUDDEN DEATHS(HEART ATTACKS)
2,3,0,2003,ASSAM,3,0,1,0,EPILEPTIC FITS/GIDDINESS
0,9,0,2003,ASSAM,9,0,9,0,ABORTIONS/CHILD BIRTH
3,3,0,2003,ASSAM,3,0,0,0,INFLUENCE OF ALCOHOL
42,85,7,2003,ASSAM,76,3,34,10,FOOD POISIONING/ACCIDENTAL INTAKE OF INSECTICIDES ETC.
2,2,0,2003,ASSAM,2,0,0,0,SNAKE BITE/ANIMAL BITE
57,88,0,2003,ASSAM,88,0,31,0,OTHER
289,345,0,2003,ASSAM,345,0,56,0,OTHER RAILWAY ACCIDENTS
39,68,0,2003,ASSAM,68,0,29,0,OTHER
156,197,0,2003,ASSAM,205,0,49,0,DROWNING
17,17,0,2003,ASSAM,18,0,1,0,FALLS
61,120,12,2003,ASSAM,120,4,59,16,FIRE
60,77,0,2003,ASSAM,81,0,21,0,SUDDEN DEATHS
110,189,7,2003,ASSAM,180,3,70,10,POISONING
84,107,19,2003,BIHAR,109,6,25,25,ELECTROCUTION
19,62,0,2003,BIHAR,75,3,56,3,GAS CYLINDER/STOVE BURST
14,28,0,2003,BIHAR,29,0,15,0,FIRE-ARMS
44,50,0,2003,BIHAR,52,0,8,0,SUDDEN DEATHS(HEART ATTACKS)
4,6,1,2003,BIHAR,6,0,2,1,EPILEPTIC FITS/GIDDINESS
0,2,0,2003,BIHAR,2,0,2,0,ABORTIONS/CHILD BIRTH
43,44,1,2003,BIHAR,43,0,0,1,INFLUENCE OF ALCOHOL
125,209,12,2003,BIHAR,225,5,100,17,FOOD POISIONING/ACCIDENTAL INTAKE OF INSECTICIDES ETC.
25,37,2,2003,BIHAR,38,0,13,2,SNAKE BITE/ANIMAL BITE
79,119,0,2003,BIHAR,119,1,40,1,OTHER
656,803,21,2003,BIHAR,804,6,148,27,OTHER RAILWAY ACCIDENTS
233,336,9,2003,BIHAR,323,3,90,12,OTHER
230,236,17,2003,BIHAR,320,2,90,19,DROWNING
45,54,5,2003,BIHAR,58,2,13,7,FALLS
128,368,6,2003,BIHAR,413,12,285,18,FIRE
91,102,2,2003,BIHAR,103,0,12,2,SUDDEN DEATHS
285,436,22,2003,BIHAR,461,6,176,28,POISONING
350,413,1,2003,CHHATTISGARH,413,0,63,1,ELECTROCUTION
1,18,0,2003,CHHATTISGARH,19,0,18,0,GAS CYLINDER/STOVE BURST
16,17,0,2003,CHHATTISGARH,17,0,1,0,FIRE-ARMS
148,179,0,2003,CHHATTISGARH,180,0,32,0,SUDDEN DEATHS(HEART ATTACKS)
52,69,0,2003,CHHATTISGARH,70,0,18,0,EPILEPTIC FITS/GIDDINESS
0,32,0,2003,CHHATTISGARH,32,0,32,0,ABORTIONS/CHILD BIRTH
135,157,0,2003,CHHATTISGARH,157,0,22,0,INFLUENCE OF ALCOHOL
367,565,3,2003,CHHATTISGARH,563,0,196,3,FOOD POISIONING/ACCIDENTAL INTAKE OF INSECTICIDES ETC.
361,645,1,2003,CHHATTISGARH,644,0,283,1,SNAKE BITE/ANIMAL BITE
185,261,0,2003,CHHATTISGARH,273,0,88,0,OTHER
312,386,1,2003,CHHATTISGARH,386,1,74,2,OTHER RAILWAY ACCIDENTS
1267,1713,0,2003,CHHATTISGARH,1742,0,475,0,OTHER
778,1187,0,2003,CHHATTISGARH,1194,0,416,0,DROWNING
265,292,0,2003,CHHATTISGARH,320,0,55,0,FALLS
189,621,4,2003,CHHATTISGARH,621,0,432,4,FIRE
335,437,0,2003,CHHATTISGARH,439,0,104,0,SUDDEN DEATHS
927,1486,4,2003,CHHATTISGARH,1495,0,568,4,POISONING
12,13,0,2003,GOA,13,0,1,0,ELECTROCUTION
1,13,0,2003,GOA,13,0,12,0,GAS CYLINDER/STOVE BURST
0,0,0,2003,GOA,0,0,0,0,FIRE-ARMS
19,21,0,2003,GOA,21,0,2,0,SUDDEN DEATHS(HEART ATTACKS)
1,1,0,2003,GOA,1,0,0,0,EPILEPTIC FITS/GIDDINESS
0,0,0,2003,GOA,0,0,0,0,ABORTIONS/CHILD BIRTH
17,17,0,2003,GOA,17,0,0,0,INFLUENCE OF ALCOHOL
3,4,0,2003,GOA,4,0,1,0,FOOD POISIONING/ACCIDENTAL INTAKE OF INSECTICIDES ETC.
1,1,0,2003,GOA,1,0,0,0,SNAKE BITE/ANIMAL BITE
1,3,0,2003,GOA,3,0,2,0,OTHER
11,13,0,2003,GOA,13,0,2,0,OTHER RAILWAY ACCIDENTS
28,41,0,2003,GOA,41,0,13,0,OTHER
172,173,0,2003,GOA,191,0,19,0,DROWNING
82,87,0,2003,GOA,87,0,5,0,FALLS
18,59,0,2003,GOA,61,0,43,0,FIRE
37,39,0,2003,GOA,39,0,2,0,SUDDEN DEATHS
5,8,0,2003,GOA,8,0,3,0,POISONING
348,433,5,2003,GUJARAT,433,4,85,9,ELECTROCUTION
145,539,2,2003,GUJARAT,544,8,399,10,GAS CYLINDER/STOVE BURST
6,7,0,2003,GUJARAT,7,0,1,0,FIRE-ARMS
889,1003,0,2003,GUJARAT,1003,0,114,0,SUDDEN DEATHS(HEART ATTACKS)
366,440,0,2003,GUJARAT,440,0,74,0,EPILEPTIC FITS/GIDDINESS
0,18,0,2003,GUJARAT,18,0,18,0,ABORTIONS/CHILD BIRTH
29,30,0,2003,GUJARAT,30,0,1,0,INFLUENCE OF ALCOHOL
194,294,3,2003,GUJARAT,290,1,96,4,FOOD POISIONING/ACCIDENTAL INTAKE OF INSECTICIDES ETC.
289,497,38,2003,GUJARAT,431,28,142,66,SNAKE BITE/ANIMAL BITE
194,276,0,2003,GUJARAT,276,0,82,0,OTHER
1067,1234,1,2003,GUJARAT,1238,0,171,1,OTHER RAILWAY ACCIDENTS
807,1028,0,2003,GUJARAT,1034,0,227,0,OTHER
1120,1294,0,2003,GUJARAT,1354,0,234,0,DROWNING
701,826,11,2003,GUJARAT,815,6,114,17,FALLS
656,2431,26,2003,GUJARAT,2359,87,1703,113,FIRE
1284,1491,0,2003,GUJARAT,1491,0,207,0,SUDDEN DEATHS
705,1111,41,2003,GUJARAT,1041,29,336,70,POISONING
160,179,0,2003,HARYANA,180,0,20,0,ELECTROCUTION
30,116,0,2003,HARYANA,116,0,86,0,GAS CYLINDER/STOVE BURST
26,40,2,2003,HARYANA,40,0,14,2,FIRE-ARMS
227,248,0,2003,HARYANA,249,0,22,0,SUDDEN DEATHS(HEART ATTACKS)
30,33,0,2003,HARYANA,33,0,3,0,EPILEPTIC FITS/GIDDINESS
0,8,0,2003,HARYANA,8,0,8,0,ABORTIONS/CHILD BIRTH
131,133,0,2003,HARYANA,133,0,2,0,INFLUENCE OF ALCOHOL
167,275,25,2003,HARYANA,230,20,63,45,FOOD POISIONING/ACCIDENTAL INTAKE OF INSECTICIDES ETC.
8,10,0,2003,HARYANA,10,0,2,0,SNAKE BITE/ANIMAL BITE
232,322,0,2003,HARYANA,332,0,100,0,OTHER
0,0,0,2003,HARYANA,0,0,0,0,OTHER RAILWAY ACCIDENTS
291,336,1,2003,HARYANA,336,0,45,1,OTHER
260,317,0,2003,HARYANA,318,0,58,0,DROWNING
117,136,0,2003,HARYANA,136,0,19,0,FALLS
161,349,0,2003,HARYANA,345,8,184,8,FIRE
388,422,0,2003,HARYANA,423,0,35,0,SUDDEN DEATHS
420,620,25,2003,HARYANA,585,20,165,45,POISONING
8,8,0,2003,HIMACHAL PRADESH,8,0,0,0,ELECTROCUTION
4,5,0,2003,HIMACHAL PRADESH,6,0,2,0,GAS CYLINDER/STOVE BURST
2,3,0,2003,HIMACHAL PRADESH,3,0,1,0,FIRE-ARMS
98,104,0,2003,HIMACHAL PRADESH,104,0,6,0,SUDDEN DEATHS(HEART ATTACKS)
17,21,0,2003,HIMACHAL PRADESH,21,0,4,0,EPILEPTIC FITS/GIDDINESS
0,2,0,2003,HIMACHAL PRADESH,2,0,2,0,ABORTIONS/CHILD BIRTH
44,45,0,2003,HIMACHAL PRADESH,45,0,1,0,INFLUENCE OF ALCOHOL
32,49,0,2003,HIMACHAL PRADESH,49,0,17,0,FOOD POISIONING/ACCIDENTAL INTAKE OF INSECTICIDES ETC.
7,8,0,2003,HIMACHAL PRADESH,8,0,1,0,SNAKE BITE/ANIMAL BITE
45,54,0,2003,HIMACHAL PRADESH,54,0,9,0,OTHER
16,16,0,2003,HIMACHAL PRADESH,16,0,0,0,OTHER RAILWAY ACCIDENTS
71,92,0,2003,HIMACHAL PRADESH,92,0,21,0,OTHER
105,104,0,2003,HIMACHAL PRADESH,115,0,10,0,DROWNING
136,142,0,2003,HIMACHAL PRADESH,142,0,6,0,FALLS
22,34,0,2003,HIMACHAL PRADESH,35,0,13,0,FIRE
159,172,0,2003,HIMACHAL PRADESH,172,0,13,0,SUDDEN DEATHS
91,119,0,2003,HIMACHAL PRADESH,119,0,28,0,POISONING
16,20,2,2003,JAMMU & KASHMIR,20,0,4,2,ELECTROCUTION
9,14,0,2003,JAMMU & KASHMIR,18,0,9,0,GAS CYLINDER/STOVE BURST
326,358,386,2003,JAMMU & KASHMIR,339,22,13,408,FIRE-ARMS
62,69,0,2003,JAMMU & KASHMIR,69,0,7,0,SUDDEN DEATHS(HEART ATTACKS)
6,14,0,2003,JAMMU & KASHMIR,14,0,8,0,EPILEPTIC FITS/GIDDINESS
0,15,0,2003,JAMMU & KASHMIR,12,0,12,0,ABORTIONS/CHILD BIRTH
10,17,0,2003,JAMMU & KASHMIR,17,0,7,0,INFLUENCE OF ALCOHOL
6,13,0,2003,JAMMU & KASHMIR,15,1,9,1,FOOD POISIONING/ACCIDENTAL INTAKE OF INSECTICIDES ETC.
5,9,0,2003,JAMMU & KASHMIR,9,0,4,0,SNAKE BITE/ANIMAL BITE
10,52,6,2003,JAMMU & KASHMIR,33,12,23,18,OTHER
42,44,0,2003,JAMMU & KASHMIR,44,0,2,0,OTHER RAILWAY ACCIDENTS
37,33,0,2003,JAMMU & KASHMIR,43,0,6,0,OTHER
49,49,0,2003,JAMMU & KASHMIR,63,0,14,0,DROWNING
53,59,0,2003,JAMMU & KASHMIR,67,0,14,0,FALLS
22,30,0,2003,JAMMU & KASHMIR,40,0,18,0,FIRE
78,115,0,2003,JAMMU & KASHMIR,112,0,34,0,SUDDEN DEATHS
23,76,6,2003,JAMMU & KASHMIR,59,13,36,19,POISONING
0,0,0,2003,JHARKHAND,0,0,0,0,ELECTROCUTION
0,0,0,2003,JHARKHAND,0,0,0,0,GAS CYLINDER/STOVE BURST
1,1,1,2003,JHARKHAND,1,0,0,1,FIRE-ARMS
6,10,0,2003,JHARKHAND,10,0,4,0,SUDDEN DEATHS(HEART ATTACKS)
0,0,0,2003,JHARKHAND,0,0,0,0,EPILEPTIC FITS/GIDDINESS
0,0,0,2003,JHARKHAND,0,0,0,0,ABORTIONS/CHILD BIRTH
7,12,1,2003,JHARKHAND,10,1,3,2,INFLUENCE OF ALCOHOL
0,0,0,2003,JHARKHAND,0,0,0,0,FOOD POISIONING/ACCIDENTAL INTAKE OF INSECTICIDES ETC.
2,8,1,2003,JHARKHAND,5,2,3,3,SNAKE BITE/ANIMAL BITE
0,0,0,2003,JHARKHAND,0,0,0,0,OTHER
118,142,75,2003,JHARKHAND,137,72,19,147,OTHER RAILWAY ACCIDENTS
45,60,5,2003,JHARKHAND,77,2,32,7,OTHER
0,0,0,2003,JHARKHAND,0,0,0,0,DROWNING
8,16,1,2003,JHARKHAND,14,1,6,2,FALLS
1,5,1,2003,JHARKHAND,4,1,3,2,FIRE
13,22,1,2003,JHARKHAND,20,1,7,2,SUDDEN DEATHS
6,14,2,2003,JHARKHAND,10,2,4,4,POISONING
283,323,5,2003,KARNATAKA,329,1,46,6,ELECTROCUTION
55,279,4,2003,KARNATAKA,280,3,225,7,GAS CYLINDER/STOVE BURST
12,13,0,2003,KARNATAKA,13,0,1,0,FIRE-ARMS
341,382,0,2003,KARNATAKA,380,0,39,0,SUDDEN DEATHS(HEART ATTACKS)
59,71,0,2003,KARNATAKA,71,0,12,0,EPILEPTIC FITS/GIDDINESS
0,7,0,2003,KARNATAKA,7,0,7,0,ABORTIONS/CHILD BIRTH
236,257,4,2003,KARNATAKA,251,2,15,6,INFLUENCE OF ALCOHOL
72,107,0,2003,KARNATAKA,110,0,38,0,FOOD POISIONING/ACCIDENTAL INTAKE OF INSECTICIDES ETC.
347,476,0,2003,KARNATAKA,480,0,133,0,SNAKE BITE/ANIMAL BITE
541,720,0,2003,KARNATAKA,731,0,190,0,OTHER
492,579,0,2003,KARNATAKA,579,0,87,0,OTHER RAILWAY ACCIDENTS
542,697,0,2003,KARNATAKA,705,0,163,0,OTHER
1002,1337,0,2003,KARNATAKA,1387,0,385,0,DROWNING
393,433,3,2003,KARNATAKA,440,0,47,3,FALLS
452,1395,8,2003,KARNATAKA,1391,4,939,12,FIRE
636,717,4,2003,KARNATAKA,709,2,73,6,SUDDEN DEATHS
1012,1367,0,2003,KARNATAKA,1385,0,373,0,POISONING
132,153,4,2003,KERALA,153,0,21,4,ELECTROCUTION
3,21,0,2003,KERALA,21,0,18,0,GAS CYLINDER/STOVE BURST
1,1,0,2003,KERALA,1,0,0,0,FIRE-ARMS
526,580,0,2003,KERALA,582,0,56,0,SUDDEN DEATHS(HEART ATTACKS)
37,46,0,2003,KERALA,48,0,11,0,EPILEPTIC FITS/GIDDINESS
0,5,0,2003,KERALA,5,0,5,0,ABORTIONS/CHILD BIRTH
47,48,0,2003,KERALA,47,1,0,1,INFLUENCE OF ALCOHOL
5,7,0,2003,KERALA,7,0,2,0,FOOD POISIONING/ACCIDENTAL INTAKE OF INSECTICIDES ETC.
24,34,0,2003,KERALA,34,0,10,0,SNAKE BITE/ANIMAL BITE
92,125,6,2003,KERALA,125,0,33,6,OTHER
122,156,0,2003,KERALA,157,0,35,0,OTHER RAILWAY ACCIDENTS
485,597,19,2003,KERALA,602,9,117,28,OTHER
884,1111,11,2003,KERALA,1140,2,256,13,DROWNING
442,478,9,2003,KERALA,483,3,41,12,FALLS
79,215,13,2003,KERALA,219,3,140,16,FIRE
610,679,0,2003,KERALA,682,1,72,1,SUDDEN DEATHS
125,172,6,2003,KERALA,172,0,47,6,POISONING
862,1109,31,2003,MADHYA PRADESH,1074,10,212,41,ELECTROCUTION
66,227,8,2003,MADHYA PRADESH,211,18,145,26,GAS CYLINDER/STOVE BURST
88,144,36,2003,MADHYA PRADESH,104,2,16,38,FIRE-ARMS
485,590,0,2003,MADHYA PRADESH,586,0,101,0,SUDDEN DEATHS(HEART ATTACKS)
121,175,0,2003,MADHYA PRADESH,175,0,54,0,EPILEPTIC FITS/GIDDINESS
0,109,0,2003,MADHYA PRADESH,109,0,109,0,ABORTIONS/CHILD BIRTH
288,298,0,2003,MADHYA PRADESH,298,0,10,0,INFLUENCE OF ALCOHOL
1054,1739,5,2003,MADHYA PRADESH,1742,5,688,10,FOOD POISIONING/ACCIDENTAL INTAKE OF INSECTICIDES ETC.
836,1453,19,2003,MADHYA PRADESH,1409,25,573,44,SNAKE BITE/ANIMAL BITE
311,449,9,2003,MADHYA PRADESH,449,0,138,9,OTHER
1050,1262,0,2003,MADHYA PRADESH,1262,0,212,0,OTHER RAILWAY ACCIDENTS
2162,2775,4,2003,MADHYA PRADESH,2775,2,613,6,OTHER
2443,3765,43,2003,MADHYA PRADESH,3719,23,1276,66,DROWNING
568,740,22,2003,MADHYA PRADESH,715,9,147,31,FALLS
602,1877,41,2003,MADHYA PRADESH,1784,71,1182,112,FIRE
894,1172,0,2003,MADHYA PRADESH,1168,0,274,0,SUDDEN DEATHS
2233,3687,33,2003,MADHYA PRADESH,3647,30,1414,63,POISONING
815,1040,56,2003,MAHARASHTRA,976,26,161,82,ELECTROCUTION
62,358,3,2003,MAHARASHTRA,359,9,297,12,GAS CYLINDER/STOVE BURST
43,31,1,2003,MAHARASHTRA,43,0,0,1,FIRE-ARMS
3475,4128,44,2003,MAHARASHTRA,4066,16,591,60,SUDDEN DEATHS(HEART ATTACKS)
880,1385,185,2003,MAHARASHTRA,1133,69,253,254,EPILEPTIC FITS/GIDDINESS
0,278,0,2003,MAHARASHTRA,278,0,278,0,ABORTIONS/CHILD BIRTH
1083,1138,35,2003,MAHARASHTRA,1104,0,21,35,INFLUENCE OF ALCOHOL
1203,2941,1009,2003,MAHARASHTRA,1797,1009,594,2018,FOOD POISIONING/ACCIDENTAL INTAKE OF INSECTICIDES ETC.
664,1812,471,2003,MAHARASHTRA,1051,298,387,769,SNAKE BITE/ANIMAL BITE
48,61,2,2003,MAHARASHTRA,59,0,11,2,OTHER
4473,7630,2421,2003,MAHARASHTRA,5036,335,563,2756,OTHER RAILWAY ACCIDENTS
9266,12332,259,2003,MAHARASHTRA,12179,72,2913,331,OTHER
3326,4597,33,2003,MAHARASHTRA,4761,11,1435,44,DROWNING
1656,2115,196,2003,MAHARASHTRA,1876,48,220,244,FALLS
1404,5754,334,2003,MAHARASHTRA,5218,397,3814,731,FIRE
5438,6929,264,2003,MAHARASHTRA,6581,85,1143,349,SUDDEN DEATHS
1936,4837,1482,2003,MAHARASHTRA,2933,1307,997,2789,POISONING
3,5,5,2003,MANIPUR,5,0,2,5,ELECTROCUTION
0,0,0,2003,MANIPUR,0,0,0,0,GAS CYLINDER/STOVE BURST
1,1,0,2003,MANIPUR,1,0,0,0,FIRE-ARMS
7,8,0,2003,MANIPUR,8,0,1,0,SUDDEN DEATHS(HEART ATTACKS)
1,1,0,2003,MANIPUR,1,0,0,0,EPILEPTIC FITS/GIDDINESS
0,0,0,2003,MANIPUR,0,0,0,0,ABORTIONS/CHILD BIRTH
0,0,0,2003,MANIPUR,0,0,0,0,INFLUENCE OF ALCOHOL
0,0,0,2003,MANIPUR,0,0,0,0,FOOD POISIONING/ACCIDENTAL INTAKE OF INSECTICIDES ETC.
0,0,0,2003,MANIPUR,0,0,0,0,SNAKE BITE/ANIMAL BITE
7,7,0,2003,MANIPUR,7,0,0,0,OTHER
0,0,0,2003,MANIPUR,0,0,0,0,OTHER RAILWAY ACCIDENTS
9,9,0,2003,MANIPUR,9,0,0,0,OTHER
14,15,0,2003,MANIPUR,15,0,1,0,DROWNING
5,5,0,2003,MANIPUR,5,0,0,0,FALLS
1,1,0,2003,MANIPUR,1,0,0,0,FIRE
8,9,0,2003,MANIPUR,9,0,1,0,SUDDEN DEATHS
7,7,0,2003,MANIPUR,7,0,0,0,POISONING
1,4,3,2003,MEGHALAYA,1,0,0,3,ELECTROCUTION
0,2,0,2003,MEGHALAYA,2,0,2,0,GAS CYLINDER/STOVE BURST
0,0,0,2003,MEGHALAYA,0,0,0,0,FIRE-ARMS
3,3,0,2003,MEGHALAYA,3,0,0,0,SUDDEN DEATHS(HEART ATTACKS)
2,2,0,2003,MEGHALAYA,2,0,0,0,EPILEPTIC FITS/GIDDINESS
0,0,0,2003,MEGHALAYA,0,0,0,0,ABORTIONS/CHILD BIRTH
5,7,1,2003,MEGHALAYA,6,0,1,1,INFLUENCE OF ALCOHOL
0,0,0,2003,MEGHALAYA,0,0,0,0,FOOD POISIONING/ACCIDENTAL INTAKE OF INSECTICIDES ETC.
0,0,0,2003,MEGHALAYA,0,0,0,0,SNAKE BITE/ANIMAL BITE
0,0,0,2003,MEGHALAYA,0,0,0,0,OTHER
0,0,0,2003,MEGHALAYA,0,0,0,0,OTHER RAILWAY ACCIDENTS
6,7,0,2003,MEGHALAYA,7,0,1,0,OTHER
9,10,0,2003,MEGHALAYA,10,0,1,0,DROWNING
2,2,0,2003,MEGHALAYA,2,0,0,0,FALLS
6,11,2,2003,MEGHALAYA,11,0,5,2,FIRE
10,12,1,2003,MEGHALAYA,11,0,1,1,SUDDEN DEATHS
0,0,0,2003,MEGHALAYA,0,0,0,0,POISONING
2,2,0,2003,MIZORAM,2,0,0,0,ELECTROCUTION
0,0,0,2003,MIZORAM,0,0,0,0,GAS CYLINDER/STOVE BURST
6,6,0,2003,MIZORAM,6,0,0,0,FIRE-ARMS
5,7,0,2003,MIZORAM,7,0,2,0,SUDDEN DEATHS(HEART ATTACKS)
1,1,0,2003,MIZORAM,1,0,0,0,EPILEPTIC FITS/GIDDINESS
0,0,0,2003,MIZORAM,0,0,0,0,ABORTIONS/CHILD BIRTH
0,1,0,2003,MIZORAM,1,0,1,0,INFLUENCE OF ALCOHOL
0,0,0,2003,MIZORAM,0,0,0,0,FOOD POISIONING/ACCIDENTAL INTAKE OF INSECTICIDES ETC.
0,0,0,2003,MIZORAM,0,0,0,0,SNAKE BITE/ANIMAL BITE
0,0,0,2003,MIZORAM,0,0,0,0,OTHER
0,0,0,2003,MIZORAM,0,0,0,0,OTHER RAILWAY ACCIDENTS
0,0,0,2003,MIZORAM,0,0,0,0,OTHER
16,15,0,2003,MIZORAM,16,0,0,0,DROWNING
11,13,0,2003,MIZORAM,13,0,2,0,FALLS
7,3,0,2003,MIZORAM,7,0,0,0,FIRE
6,9,0,2003,MIZORAM,9,0,3,0,SUDDEN DEATHS
0,0,0,2003,MIZORAM,0,0,0,0,POISONING
0,0,0,2003,NAGALAND,0,0,0,0,ELECTROCUTION
0,0,0,2003,NAGALAND,0,0,0,0,GAS CYLINDER/STOVE BURST
5,4,0,2003,NAGALAND,5,0,0,0,FIRE-ARMS
4,4,0,2003,NAGALAND,4,0,0,0,SUDDEN DEATHS(HEART ATTACKS)
0,0,0,2003,NAGALAND,0,0,0,0,EPILEPTIC FITS/GIDDINESS
0,0,0,2003,NAGALAND,0,0,0,0,ABORTIONS/CHILD BIRTH
0,0,0,2003,NAGALAND,0,0,0,0,INFLUENCE OF ALCOHOL
0,0,0,2003,NAGALAND,0,0,0,0,FOOD POISIONING/ACCIDENTAL INTAKE OF INSECTICIDES ETC.
0,0,0,2003,NAGALAND,0,0,0,0,SNAKE BITE/ANIMAL BITE
1,1,0,2003,NAGALAND,1,0,0,0,OTHER
5,5,0,2003,NAGALAND,5,0,0,0,OTHER RAILWAY ACCIDENTS
5,6,0,2003,NAGALAND,6,0,1,0,OTHER
7,4,0,2003,NAGALAND,7,0,0,0,DROWNING
0,0,0,2003,NAGALAND,0,0,0,0,FALLS
1,1,0,2003,NAGALAND,1,0,0,0,FIRE
4,4,0,2003,NAGALAND,4,0,0,0,SUDDEN DEATHS
1,1,0,2003,NAGALAND,1,0,0,0,POISONING
141,173,5,2003,ODISHA,178,3,37,8,ELECTROCUTION
1,25,0,2003,ODISHA,25,0,24,0,GAS CYLINDER/STOVE BURST
3,1,0,2003,ODISHA,3,0,0,0,FIRE-ARMS
84,119,0,2003,ODISHA,122,0,38,0,SUDDEN DEATHS(HEART ATTACKS)
36,50,0,2003,ODISHA,50,0,14,0,EPILEPTIC FITS/GIDDINESS
0,15,0,2003,ODISHA,15,0,15,0,ABORTIONS/CHILD BIRTH
29,29,0,2003,ODISHA,29,0,0,0,INFLUENCE OF ALCOHOL
252,386,31,2003,ODISHA,390,9,138,40,FOOD POISIONING/ACCIDENTAL INTAKE OF INSECTICIDES ETC.
303,462,0,2003,ODISHA,489,0,186,0,SNAKE BITE/ANIMAL BITE
245,336,0,2003,ODISHA,340,0,95,0,OTHER
301,407,9,2003,ODISHA,409,2,108,11,OTHER RAILWAY ACCIDENTS
274,370,0,2003,ODISHA,385,0,111,0,OTHER
283,409,3,2003,ODISHA,432,0,149,3,DROWNING
317,341,39,2003,ODISHA,369,11,52,50,FALLS
198,370,17,2003,ODISHA,381,4,183,21,FIRE
149,213,0,2003,ODISHA,216,0,67,0,SUDDEN DEATHS
802,1186,31,2003,ODISHA,1221,9,419,40,POISONING
173,194,0,2003,PUNJAB,194,0,21,0,ELECTROCUTION
43,109,0,2003,PUNJAB,109,0,66,0,GAS CYLINDER/STOVE BURST
13,14,0,2003,PUNJAB,14,0,1,0,FIRE-ARMS
231,257,0,2003,PUNJAB,257,0,26,0,SUDDEN DEATHS(HEART ATTACKS)
50,53,0,2003,PUNJAB,53,0,3,0,EPILEPTIC FITS/GIDDINESS
0,2,0,2003,PUNJAB,2,0,2,0,ABORTIONS/CHILD BIRTH
82,82,0,2003,PUNJAB,82,0,0,0,INFLUENCE OF ALCOHOL
109,143,0,2003,PUNJAB,143,0,34,0,FOOD POISIONING/ACCIDENTAL INTAKE OF INSECTICIDES ETC.
23,28,0,2003,PUNJAB,28,0,5,0,SNAKE BITE/ANIMAL BITE
190,256,0,2003,PUNJAB,256,0,66,0,OTHER
560,701,0,2003,PUNJAB,701,0,141,0,OTHER RAILWAY ACCIDENTS
229,261,0,2003,PUNJAB,266,0,37,0,OTHER
262,308,0,2003,PUNJAB,308,0,46,0,DROWNING
138,152,0,2003,PUNJAB,152,0,14,0,FALLS
160,347,14,2003,PUNJAB,324,9,164,23,FIRE
363,394,0,2003,PUNJAB,394,0,31,0,SUDDEN DEATHS
419,549,0,2003,PUNJAB,549,0,130,0,POISONING
326,364,0,2003,RAJASTHAN,370,0,44,0,ELECTROCUTION
23,91,0,2003,RAJASTHAN,92,1,69,1,GAS CYLINDER/STOVE BURST
6,6,0,2003,RAJASTHAN,6,0,0,0,FIRE-ARMS
374,461,0,2003,RAJASTHAN,461,0,87,0,SUDDEN DEATHS(HEART ATTACKS)
153,174,0,2003,RAJASTHAN,176,0,23,0,EPILEPTIC FITS/GIDDINESS
0,24,0,2003,RAJASTHAN,24,0,24,0,ABORTIONS/CHILD BIRTH
210,211,1,2003,RAJASTHAN,210,0,0,1,INFLUENCE OF ALCOHOL
686,1018,4,2003,RAJASTHAN,1023,2,337,6,FOOD POISIONING/ACCIDENTAL INTAKE OF INSECTICIDES ETC.
50,73,0,2003,RAJASTHAN,73,0,23,0,SNAKE BITE/ANIMAL BITE
82,112,0,2003,RAJASTHAN,113,0,31,0,OTHER
231,264,0,2003,RAJASTHAN,265,0,34,0,OTHER RAILWAY ACCIDENTS
1267,2120,3,2003,RAJASTHAN,1642,1,375,4,OTHER
1121,1411,1,2003,RAJASTHAN,1471,0,350,1,DROWNING
457,596,3,2003,RAJASTHAN,593,0,136,3,FALLS
263,638,1,2003,RAJASTHAN,647,1,384,2,FIRE
737,870,1,2003,RAJASTHAN,871,0,134,1,SUDDEN DEATHS
827,1206,7,2003,RAJASTHAN,1218,2,391,9,POISONING
2,2,0,2003,SIKKIM,2,0,0,0,ELECTROCUTION
2,2,0,2003,SIKKIM,2,0,0,0,GAS CYLINDER/STOVE BURST
0,0,0,2003,SIKKIM,0,0,0,0,FIRE-ARMS
1,1,0,2003,SIKKIM,1,0,0,0,SUDDEN DEATHS(HEART ATTACKS)
0,0,0,2003,SIKKIM,0,0,0,0,EPILEPTIC FITS/GIDDINESS
0,0,0,2003,SIKKIM,0,0,0,0,ABORTIONS/CHILD BIRTH
9,9,0,2003,SIKKIM,9,0,0,0,INFLUENCE OF ALCOHOL
2,2,0,2003,SIKKIM,2,0,0,0,FOOD POISIONING/ACCIDENTAL INTAKE OF INSECTICIDES ETC.
0,0,0,2003,SIKKIM,0,0,0,0,SNAKE BITE/ANIMAL BITE
0,1,0,2003,SIKKIM,1,0,1,0,OTHER
0,0,0,2003,SIKKIM,0,0,0,0,OTHER RAILWAY ACCIDENTS
0,0,0,2003,SIKKIM,0,0,0,0,OTHER
15,20,0,2003,SIKKIM,20,0,5,0,DROWNING
17,21,0,2003,SIKKIM,21,0,4,0,FALLS
3,9,0,2003,SIKKIM,9,0,6,0,FIRE
10,10,0,2003,SIKKIM,10,0,0,0,SUDDEN DEATHS
2,3,0,2003,SIKKIM,3,0,1,0,POISONING
225,261,9,2003,TAMIL NADU,260,0,35,9,ELECTROCUTION
110,567,3,2003,TAMIL NADU,570,11,460,14,GAS CYLINDER/STOVE BURST
0,0,0,2003,TAMIL NADU,0,0,0,0,FIRE-ARMS
526,610,0,2003,TAMIL NADU,611,0,85,0,SUDDEN DEATHS(HEART ATTACKS)
73,98,5,2003,TAMIL NADU,98,0,25,5,EPILEPTIC FITS/GIDDINESS
0,21,0,2003,TAMIL NADU,21,0,21,0,ABORTIONS/CHILD BIRTH
95,95,0,2003,TAMIL NADU,95,0,0,0,INFLUENCE OF ALCOHOL
117,175,0,2003,TAMIL NADU,169,0,52,0,FOOD POISIONING/ACCIDENTAL INTAKE OF INSECTICIDES ETC.
260,368,0,2003,TAMIL NADU,370,0,110,0,SNAKE BITE/ANIMAL BITE
794,1141,4,2003,TAMIL NADU,1154,2,360,6,OTHER
0,0,0,2003,TAMIL NADU,0,0,0,0,OTHER RAILWAY ACCIDENTS
1292,1719,10,2003,TAMIL NADU,1707,6,415,16,OTHER
608,833,17,2003,TAMIL NADU,841,8,233,25,DROWNING
343,407,6,2003,TAMIL NADU,399,3,56,9,FALLS
464,1481,12,2003,TAMIL NADU,1489,20,1025,32,FIRE
694,824,5,2003,TAMIL NADU,825,0,131,5,SUDDEN DEATHS
1191,1689,92,2003,TAMIL NADU,1714,2,523,94,POISONING
9,10,0,2003,TRIPURA,10,0,1,0,ELECTROCUTION
0,1,0,2003,TRIPURA,1,0,1,0,GAS CYLINDER/STOVE BURST
1,1,0,2003,TRIPURA,1,0,0,0,FIRE-ARMS
0,0,0,2003,TRIPURA,0,0,0,0,SUDDEN DEATHS(HEART ATTACKS)
0,0,0,2003,TRIPURA,0,0,0,0,EPILEPTIC FITS/GIDDINESS
0,0,0,2003,TRIPURA,0,0,0,0,ABORTIONS/CHILD BIRTH
0,0,0,2003,TRIPURA,0,0,0,0,INFLUENCE OF ALCOHOL
0,0,0,2003,TRIPURA,0,0,0,0,FOOD POISIONING/ACCIDENTAL INTAKE OF INSECTICIDES ETC.
0,0,0,2003,TRIPURA,0,0,0,0,SNAKE BITE/ANIMAL BITE
0,0,0,2003,TRIPURA,0,0,0,0,OTHER
0,0,0,2003,TRIPURA,0,0,0,0,OTHER RAILWAY ACCIDENTS
0,0,0,2003,TRIPURA,0,0,0,0,OTHER
25,32,0,2003,TRIPURA,32,0,7,0,DROWNING
2,2,0,2003,TRIPURA,2,0,0,0,FALLS
6,8,0,2003,TRIPURA,8,0,2,0,FIRE
0,0,0,2003,TRIPURA,0,0,0,0,SUDDEN DEATHS
0,0,0,2003,TRIPURA,0,0,0,0,POISONING
292,328,38,2003,UTTAR PRADESH,345,12,53,50,ELECTROCUTION
21,122,8,2003,UTTAR PRADESH,124,11,103,19,GAS CYLINDER/STOVE BURST
1037,1689,675,2003,UTTAR PRADESH,1218,144,181,819,FIRE-ARMS
160,190,56,2003,UTTAR PRADESH,198,4,38,60,SUDDEN DEATHS(HEART ATTACKS)
38,54,3,2003,UTTAR PRADESH,51,0,13,3,EPILEPTIC FITS/GIDDINESS
0,45,0,2003,UTTAR PRADESH,41,3,41,3,ABORTIONS/CHILD BIRTH
113,121,13,2003,UTTAR PRADESH,117,0,4,13,INFLUENCE OF ALCOHOL
388,552,29,2003,UTTAR PRADESH,574,23,186,52,FOOD POISIONING/ACCIDENTAL INTAKE OF INSECTICIDES ETC.
38,40,2,2003,UTTAR PRADESH,52,0,14,2,SNAKE BITE/ANIMAL BITE
118,190,20,2003,UTTAR PRADESH,187,11,69,31,OTHER
1997,2321,48,2003,UTTAR PRADESH,2386,23,389,71,OTHER RAILWAY ACCIDENTS
1013,1324,224,2003,UTTAR PRADESH,1321,81,308,305,OTHER
401,473,54,2003,UTTAR PRADESH,561,15,160,69,DROWNING
166,217,32,2003,UTTAR PRADESH,224,11,58,43,FALLS
296,874,80,2003,UTTAR PRADESH,901,78,605,158,FIRE
311,410,72,2003,UTTAR PRADESH,407,7,96,79,SUDDEN DEATHS
586,836,63,2003,UTTAR PRADESH,860,49,274,112,POISONING
18,22,1,2003,UTTARAKHAND,22,0,4,1,ELECTROCUTION
3,11,0,2003,UTTARAKHAND,11,0,8,0,GAS CYLINDER/STOVE BURST
30,28,3,2003,UTTARAKHAND,32,0,2,3,FIRE-ARMS
42,45,0,2003,UTTARAKHAND,45,0,3,0,SUDDEN DEATHS(HEART ATTACKS)
7,7,0,2003,UTTARAKHAND,7,0,0,0,EPILEPTIC FITS/GIDDINESS
0,3,0,2003,UTTARAKHAND,3,0,3,0,ABORTIONS/CHILD BIRTH
14,14,0,2003,UTTARAKHAND,14,0,0,0,INFLUENCE OF ALCOHOL
74,118,1,2003,UTTARAKHAND,117,0,43,1,FOOD POISIONING/ACCIDENTAL INTAKE OF INSECTICIDES ETC.
4,5,0,2003,UTTARAKHAND,5,0,1,0,SNAKE BITE/ANIMAL BITE
12,27,1,2003,UTTARAKHAND,26,0,14,1,OTHER
29,33,3,2003,UTTARAKHAND,33,0,4,3,OTHER RAILWAY ACCIDENTS
50,59,0,2003,UTTARAKHAND,59,0,9,0,OTHER
64,77,0,2003,UTTARAKHAND,79,0,15,0,DROWNING
62,73,1,2003,UTTARAKHAND,73,0,11,1,FALLS
37,78,2,2003,UTTARAKHAND,81,0,44,2,FIRE
63,69,0,2003,UTTARAKHAND,69,0,6,0,SUDDEN DEATHS
91,151,2,2003,UTTARAKHAND,149,0,58,2,POISONING
79,108,18,2003,WEST BENGAL,99,10,20,28,ELECTROCUTION
3,54,6,2003,WEST BENGAL,32,19,29,25,GAS CYLINDER/STOVE BURST
46,66,17,2003,WEST BENGAL,52,3,6,20,FIRE-ARMS
301,441,18,2003,WEST BENGAL,407,16,106,34,SUDDEN DEATHS(HEART ATTACKS)
1,1,0,2003,WEST BENGAL,1,0,0,0,EPILEPTIC FITS/GIDDINESS
0,22,0,2003,WEST BENGAL,20,2,20,2,ABORTIONS/CHILD BIRTH
37,53,12,2003,WEST BENGAL,39,3,2,15,INFLUENCE OF ALCOHOL
49,82,44,2003,WEST BENGAL,81,19,32,63,FOOD POISIONING/ACCIDENTAL INTAKE OF INSECTICIDES ETC.
147,231,26,2003,WEST BENGAL,211,4,64,30,SNAKE BITE/ANIMAL BITE
173,336,30,2003,WEST BENGAL,320,22,147,52,OTHER
1708,2217,0,2003,WEST BENGAL,2218,1,510,1,OTHER RAILWAY ACCIDENTS
193,246,31,2003,WEST BENGAL,301,13,108,44,OTHER
298,407,33,2003,WEST BENGAL,407,20,109,53,DROWNING
213,342,57,2003,WEST BENGAL,271,26,58,83,FALLS
139,401,88,2003,WEST BENGAL,310,60,171,148,FIRE
339,517,30,2003,WEST BENGAL,467,21,128,51,SUDDEN DEATHS
369,650,101,2003,WEST BENGAL,612,45,243,146,POISONING
0,0,0,2003,A & N ISLANDS,0,0,0,0,ELECTROCUTION
0,0,0,2003,A & N ISLANDS,0,0,0,0,GAS CYLINDER/STOVE BURST
0,0,0,2003,A & N ISLANDS,0,0,0,0,FIRE-ARMS
12,19,0,2003,A & N ISLANDS,19,0,7,0,SUDDEN DEATHS(HEART ATTACKS)
1,1,0,2003,A & N ISLANDS,1,0,0,0,EPILEPTIC FITS/GIDDINESS
0,0,0,2003,A & N ISLANDS,0,0,0,0,ABORTIONS/CHILD BIRTH
12,12,0,2003,A & N ISLANDS,12,0,0,0,INFLUENCE OF ALCOHOL
0,0,0,2003,A & N ISLANDS,0,0,0,0,FOOD POISIONING/ACCIDENTAL INTAKE OF INSECTICIDES ETC.
1,1,0,2003,A & N ISLANDS,1,0,0,0,SNAKE BITE/ANIMAL BITE
0,0,0,2003,A & N ISLANDS,0,0,0,0,OTHER
0,0,0,2003,A & N ISLANDS,0,0,0,0,OTHER RAILWAY ACCIDENTS
18,25,0,2003,A & N ISLANDS,25,0,7,0,OTHER
30,40,0,2003,A & N ISLANDS,43,0,13,0,DROWNING
11,12,0,2003,A & N ISLANDS,12,0,1,0,FALLS
8,28,0,2003,A & N ISLANDS,28,0,20,0,FIRE
25,32,0,2003,A & N ISLANDS,32,0,7,0,SUDDEN DEATHS
1,1,0,2003,A & N ISLANDS,1,0,0,0,POISONING
6,6,0,2003,CHANDIGARH,7,1,1,1,ELECTROCUTION
4,14,0,2003,CHANDIGARH,14,0,10,0,GAS CYLINDER/STOVE BURST
1,1,0,2003,CHANDIGARH,1,0,0,0,FIRE-ARMS
40,41,0,2003,CHANDIGARH,41,0,1,0,SUDDEN DEATHS(HEART ATTACKS)
1,1,0,2003,CHANDIGARH,1,0,0,0,EPILEPTIC FITS/GIDDINESS
0,4,0,2003,CHANDIGARH,4,0,4,0,ABORTIONS/CHILD BIRTH
21,21,0,2003,CHANDIGARH,21,0,0,0,INFLUENCE OF ALCOHOL
4,4,0,2003,CHANDIGARH,7,0,3,0,FOOD POISIONING/ACCIDENTAL INTAKE OF INSECTICIDES ETC.
0,0,0,2003,CHANDIGARH,0,0,0,0,SNAKE BITE/ANIMAL BITE
9,14,0,2003,CHANDIGARH,15,0,6,0,OTHER
0,0,0,2003,CHANDIGARH,0,0,0,0,OTHER RAILWAY ACCIDENTS
74,89,0,2003,CHANDIGARH,89,0,15,0,OTHER
9,9,0,2003,CHANDIGARH,9,0,0,0,DROWNING
12,15,0,2003,CHANDIGARH,15,0,3,0,FALLS
6,26,0,2003,CHANDIGARH,26,0,20,0,FIRE
62,67,0,2003,CHANDIGARH,67,0,5,0,SUDDEN DEATHS
13,18,0,2003,CHANDIGARH,22,0,9,0,POISONING
6,6,0,2003,D & N HAVELI,6,0,0,0,ELECTROCUTION
0,0,0,2003,D & N HAVELI,0,0,0,0,GAS CYLINDER/STOVE BURST
0,0,0,2003,D & N HAVELI,0,0,0,0,FIRE-ARMS
16,18,0,2003,D & N HAVELI,18,0,2,0,SUDDEN DEATHS(HEART ATTACKS)
0,0,0,2003,D & N HAVELI,0,0,0,0,EPILEPTIC FITS/GIDDINESS
0,0,0,2003,D & N HAVELI,0,0,0,0,ABORTIONS/CHILD BIRTH
0,0,0,2003,D & N HAVELI,0,0,0,0,INFLUENCE OF ALCOHOL
0,0,0,2003,D & N HAVELI,0,0,0,0,FOOD POISIONING/ACCIDENTAL INTAKE OF INSECTICIDES ETC.
1,2,0,2003,D & N HAVELI,2,0,1,0,SNAKE BITE/ANIMAL BITE
0,0,0,2003,D & N HAVELI,0,0,0,0,OTHER
0,0,0,2003,D & N HAVELI,0,0,0,0,OTHER RAILWAY ACCIDENTS
17,21,0,2003,D & N HAVELI,21,0,4,0,OTHER
13,15,0,2003,D & N HAVELI,16,0,3,0,DROWNING
11,12,0,2003,D & N HAVELI,12,0,1,0,FALLS
2,3,0,2003,D & N HAVELI,3,0,1,0,FIRE
16,18,0,2003,D & N HAVELI,18,0,2,0,SUDDEN DEATHS
1,2,0,2003,D & N HAVELI,2,0,1,0,POISONING
2,2,0,2003,DAMAN & DIU,2,0,0,0,ELECTROCUTION
0,0,0,2003,DAMAN & DIU,0,0,0,0,GAS CYLINDER/STOVE BURST
0,0,0,2003,DAMAN & DIU,0,0,0,0,FIRE-ARMS
7,8,0,2003,DAMAN & DIU,8,0,1,0,SUDDEN DEATHS(HEART ATTACKS)
1,1,0,2003,DAMAN & DIU,1,0,0,0,EPILEPTIC FITS/GIDDINESS
0,0,0,2003,DAMAN & DIU,0,0,0,0,ABORTIONS/CHILD BIRTH
2,2,0,2003,DAMAN & DIU,2,0,0,0,INFLUENCE OF ALCOHOL
0,1,0,2003,DAMAN & DIU,1,0,1,0,FOOD POISIONING/ACCIDENTAL INTAKE OF INSECTICIDES ETC.
0,0,0,2003,DAMAN & DIU,0,0,0,0,SNAKE BITE/ANIMAL BITE
1,1,0,2003,DAMAN & DIU,1,0,0,0,OTHER
0,0,0,2003,DAMAN & DIU,0,0,0,0,OTHER RAILWAY ACCIDENTS
9,9,0,2003,DAMAN & DIU,9,0,0,0,OTHER
14,15,0,2003,DAMAN & DIU,15,0,1,0,DROWNING
3,3,0,2003,DAMAN & DIU,3,0,0,0,FALLS
3,3,0,2003,DAMAN & DIU,5,0,2,0,FIRE
10,11,0,2003,DAMAN & DIU,11,0,1,0,SUDDEN DEATHS
1,2,0,2003,DAMAN & DIU,2,0,1,0,POISONING
174,194,8,2003,DELHI(UT),197,2,23,10,ELECTROCUTION
40,153,6,2003,DELHI(UT),157,5,117,11,GAS CYLINDER/STOVE BURST
19,38,18,2003,DELHI(UT),27,1,8,19,FIRE-ARMS
178,193,0,2003,DELHI(UT),193,0,15,0,SUDDEN DEATHS(HEART ATTACKS)
14,19,0,2003,DELHI(UT),19,0,5,0,EPILEPTIC FITS/GIDDINESS
0,11,0,2003,DELHI(UT),11,0,11,0,ABORTIONS/CHILD BIRTH
62,64,0,2003,DELHI(UT),64,0,2,0,INFLUENCE OF ALCOHOL
57,74,18,2003,DELHI(UT),78,0,21,18,FOOD POISIONING/ACCIDENTAL INTAKE OF INSECTICIDES ETC.
5,8,0,2003,DELHI(UT),8,0,3,0,SNAKE BITE/ANIMAL BITE
68,118,0,2003,DELHI(UT),118,0,50,0,OTHER
707,807,0,2003,DELHI(UT),818,0,111,0,OTHER RAILWAY ACCIDENTS
484,652,17,2003,DELHI(UT),660,3,176,20,OTHER
132,148,0,2003,DELHI(UT),150,0,18,0,DROWNING
258,307,6,2003,DELHI(UT),314,0,56,6,FALLS
165,403,13,2003,DELHI(UT),421,6,256,19,FIRE
254,287,0,2003,DELHI(UT),287,0,33,0,SUDDEN DEATHS
132,206,19,2003,DELHI(UT),210,2,78,21,POISONING
0,0,0,2003,LAKSHADWEEP,0,0,0,0,ELECTROCUTION
0,0,0,2003,LAKSHADWEEP,0,0,0,0,GAS CYLINDER/STOVE BURST
0,0,0,2003,LAKSHADWEEP,0,0,0,0,FIRE-ARMS
0,0,0,2003,LAKSHADWEEP,0,0,0,0,SUDDEN DEATHS(HEART ATTACKS)
0,0,0,2003,LAKSHADWEEP,0,0,0,0,EPILEPTIC FITS/GIDDINESS
0,0,0,2003,LAKSHADWEEP,0,0,0,0,ABORTIONS/CHILD BIRTH
0,0,0,2003,LAKSHADWEEP,0,0,0,0,INFLUENCE OF ALCOHOL
0,0,0,2003,LAKSHADWEEP,0,0,0,0,FOOD POISIONING/ACCIDENTAL INTAKE OF INSECTICIDES ETC.
0,0,0,2003,LAKSHADWEEP,0,0,0,0,SNAKE BITE/ANIMAL BITE
0,0,0,2003,LAKSHADWEEP,0,0,0,0,OTHER
0,0,0,2003,LAKSHADWEEP,0,0,0,0,OTHER RAILWAY ACCIDENTS
0,0,0,2003,LAKSHADWEEP,0,0,0,0,OTHER
0,0,0,2003,LAKSHADWEEP,0,0,0,0,DROWNING
0,0,0,2003,LAKSHADWEEP,0,0,0,0,FALLS
0,0,0,2003,LAKSHADWEEP,0,0,0,0,FIRE
0,0,0,2003,LAKSHADWEEP,0,0,0,0,SUDDEN DEATHS
0,0,0,2003,LAKSHADWEEP,0,0,0,0,POISONING
22,27,0,2003,PUDUCHERRY,27,0,5,0,ELECTROCUTION
0,0,0,2003,PUDUCHERRY,0,0,0,0,GAS CYLINDER/STOVE BURST
0,0,0,2003,PUDUCHERRY,0,0,0,0,FIRE-ARMS
40,47,0,2003,PUDUCHERRY,47,0,7,0,SUDDEN DEATHS(HEART ATTACKS)
8,10,0,2003,PUDUCHERRY,10,0,2,0,EPILEPTIC FITS/GIDDINESS
0,0,0,2003,PUDUCHERRY,0,0,0,0,ABORTIONS/CHILD BIRTH
119,124,0,2003,PUDUCHERRY,124,0,5,0,INFLUENCE OF ALCOHOL
1,2,0,2003,PUDUCHERRY,2,0,1,0,FOOD POISIONING/ACCIDENTAL INTAKE OF INSECTICIDES ETC.
7,11,0,2003,PUDUCHERRY,11,0,4,0,SNAKE BITE/ANIMAL BITE
5,6,0,2003,PUDUCHERRY,6,0,1,0,OTHER
0,0,0,2003,PUDUCHERRY,0,0,0,0,OTHER RAILWAY ACCIDENTS
62,78,0,2003,PUDUCHERRY,78,0,16,0,OTHER
63,65,0,2003,PUDUCHERRY,71,0,8,0,DROWNING
23,27,0,2003,PUDUCHERRY,27,0,4,0,FALLS
13,49,0,2003,PUDUCHERRY,49,0,36,0,FIRE
167,181,0,2003,PUDUCHERRY,181,0,14,0,SUDDEN DEATHS
13,19,0,2003,PUDUCHERRY,19,0,6,0,POISONING
