CASES,MALE INJURED,STATE/UT,YEAR,INJURED,CAUSE,FEMALE KILLED,FEMALE INJURED,MALE KILLED,TOTAL KILLED
746,4,ANDHRA PRADESH,2004,6,ELECTROCUTION,99,2,669,768
537,12,ANDHRA PRADESH,2004,70,GAS CYLINDER/STOVE BURST,422,58,104,526
3,0,ANDHRA PRADESH,2004,0,FIRE-ARMS,0,0,3,3
409,0,ANDHRA PRADESH,2004,0,SUDDEN DEATHS(HEART ATTACKS),95,0,316,411
103,1,ANDHRA PRADESH,2004,1,EPILEPTIC FITS/GIDDINESS,33,0,70,103
32,0,ANDHRA PRADESH,2004,0,ABORTIONS/CHILD BIRTH,32,0,0,32
249,7,ANDHRA PRADESH,2004,7,INFLUENCE OF ALCOHOL,8,0,233,241
147,14,ANDHRA PRADESH,2004,17,FOOD POISIONING/ACCIDENTAL INTAKE OF INSECTICIDES ETC.,36,3,95,131
675,9,ANDHRA PRADESH,2004,12,SNAKE BITE/ANIMAL BITE,178,3,487,665
824,0,ANDHRA PRADESH,2004,2,OTHER,279,2,555,834
992,19,ANDHRA PRADESH,2004,21,OTHER RAILWAY ACCIDENTS,153,2,1051,1204
987,17,ANDHRA PRADESH,2004,29,OTHER,278,12,691,969
1168,10,ANDHRA PRADESH,2004,12,DROWNING,250,2,963,1213
708,14,ANDHRA PRADESH,2004,18,FALLS,93,4,609,702
1509,49,ANDHRA PRADESH,2004,133,FIRE,906,84,577,1483
793,8,ANDHRA PRADESH,2004,8,SUDDEN DEATHS,168,0,619,787
1730,23,ANDHRA PRADESH,2004,31,POISONING,498,8,1216,1714
0,0,ARUNACHAL PRADESH,2004,0,ELECTROCUTION,0,0,0,0
1,0,ARUNACHAL PRADESH,2004,0,GAS CYLINDER/STOVE BURST,1,0,0,1
0,0,ARUNACHAL PRADESH,2004,0,FIRE-ARMS,0,0,0,0
8,0,ARUNACHAL PRADESH,2004,0,SUDDEN DEATHS(HEART ATTACKS),1,0,7,8
0,0,ARUNACHAL PRADESH,2004,0,EPILEPTIC FITS/GIDDINESS,0,0,0,0
0,0,ARUNACHAL PRADESH,2004,0,ABORTIONS/CHILD BIRTH,0,0,0,0
1,0,ARUNACHAL PRADESH,2004,0,INFLUENCE OF ALCOHOL,0,0,1,1
2,0,ARUNACHAL PRADESH,2004,0,FOOD POISIONING/ACCIDENTAL INTAKE OF INSECTICIDES ETC.,0,0,3,3
0,0,ARUNACHAL PRADESH,2004,0,SNAKE BITE/ANIMAL BITE,0,0,0,0
3,0,ARUNACHAL PRADESH,2004,0,OTHER,2,0,1,3
0,0,ARUNACHAL PRADESH,2004,0,OTHER RAILWAY ACCIDENTS,0,0,0,0
0,0,ARUNACHAL PRADESH,2004,0,OTHER,0,0,0,0
16,0,ARUNACHAL PRADESH,2004,0,DROWNING,4,0,13,17
7,0,ARUNACHAL PRADESH,2004,0,FALLS,0,0,7,7
5,0,ARUNACHAL PRADESH,2004,0,FIRE,4,0,2,6
9,0,ARUNACHAL PRADESH,2004,0,SUDDEN DEATHS,1,0,8,9
5,0,ARUNACHAL PRADESH,2004,0,POISONING,2,0,4,6
28,0,ASSAM,2004,0,ELECTROCUTION,5,0,23,28
13,0,ASSAM,2004,0,GAS CYLINDER/STOVE BURST,12,0,1,13
16,0,ASSAM,2004,0,FIRE-ARMS,1,0,15,16
35,0,ASSAM,2004,0,SUDDEN DEATHS(HEART ATTACKS),7,0,28,35
1,0,ASSAM,2004,0,EPILEPTIC FITS/GIDDINESS,0,0,1,1
7,0,ASSAM,2004,0,ABORTIONS/CHILD BIRTH,7,0,0,7
0,0,ASSAM,2004,0,INFLUENCE OF ALCOHOL,0,0,0,0
18,0,ASSAM,2004,0,FOOD POISIONING/ACCIDENTAL INTAKE OF INSECTICIDES ETC.,5,0,13,18
4,0,ASSAM,2004,0,SNAKE BITE/ANIMAL BITE,2,0,2,4
135,0,ASSAM,2004,0,OTHER,60,0,75,135
372,2,ASSAM,2004,3,OTHER RAILWAY ACCIDENTS,72,1,300,372
85,0,ASSAM,2004,0,OTHER,14,0,71,85
266,0,ASSAM,2004,0,DROWNING,66,0,214,280
11,0,ASSAM,2004,0,FALLS,1,0,10,11
107,2,ASSAM,2004,2,FIRE,63,0,42,105
43,0,ASSAM,2004,0,SUDDEN DEATHS,14,0,29,43
169,0,ASSAM,2004,0,POISONING,73,0,96,169
101,3,BIHAR,2004,5,ELECTROCUTION,26,2,78,104
88,4,BIHAR,2004,5,GAS CYLINDER/STOVE BURST,62,1,18,80
7,0,BIHAR,2004,0,FIRE-ARMS,4,0,3,7
78,7,BIHAR,2004,22,SUDDEN DEATHS(HEART ATTACKS),17,15,43,60
15,0,BIHAR,2004,0,EPILEPTIC FITS/GIDDINESS,4,0,11,15
3,0,BIHAR,2004,0,ABORTIONS/CHILD BIRTH,3,0,0,3
33,2,BIHAR,2004,2,INFLUENCE OF ALCOHOL,1,0,30,31
145,5,BIHAR,2004,6,FOOD POISIONING/ACCIDENTAL INTAKE OF INSECTICIDES ETC.,63,1,87,150
62,5,BIHAR,2004,8,SNAKE BITE/ANIMAL BITE,22,3,39,61
108,16,BIHAR,2004,24,OTHER,48,8,62,110
752,4,BIHAR,2004,7,OTHER RAILWAY ACCIDENTS,125,3,673,798
195,20,BIHAR,2004,29,OTHER,40,9,136,176
246,10,BIHAR,2004,16,DROWNING,102,6,189,291
69,8,BIHAR,2004,12,FALLS,22,4,45,67
341,18,BIHAR,2004,38,FIRE,204,20,116,320
129,9,BIHAR,2004,24,SUDDEN DEATHS,25,15,84,109
506,33,BIHAR,2004,96,POISONING,206,63,286,492
377,0,CHHATTISGARH,2004,0,ELECTROCUTION,66,0,311,377
11,0,CHHATTISGARH,2004,0,GAS CYLINDER/STOVE BURST,8,0,3,11
10,0,CHHATTISGARH,2004,0,FIRE-ARMS,1,0,9,10
198,0,CHHATTISGARH,2004,0,SUDDEN DEATHS(HEART ATTACKS),35,0,163,198
80,0,CHHATTISGARH,2004,0,EPILEPTIC FITS/GIDDINESS,28,0,52,80
25,0,CHHATTISGARH,2004,0,ABORTIONS/CHILD BIRTH,25,0,0,25
166,0,CHHATTISGARH,2004,0,INFLUENCE OF ALCOHOL,21,0,145,166
356,0,CHHATTISGARH,2004,0,FOOD POISIONING/ACCIDENTAL INTAKE OF INSECTICIDES ETC.,124,0,232,356
767,0,CHHATTISGARH,2004,0,SNAKE BITE/ANIMAL BITE,312,0,455,767
170,0,CHHATTISGARH,2004,0,OTHER,65,0,105,170
330,0,CHHATTISGARH,2004,0,OTHER RAILWAY ACCIDENTS,43,0,287,330
1755,0,CHHATTISGARH,2004,0,OTHER,467,0,1238,1705
1348,0,CHHATTISGARH,2004,0,DROWNING,430,0,920,1350
306,5,CHHATTISGARH,2004,7,FALLS,59,2,247,306
487,0,CHHATTISGARH,2004,0,FIRE,337,0,148,485
469,0,CHHATTISGARH,2004,0,SUDDEN DEATHS,109,0,360,469
1299,0,CHHATTISGARH,2004,0,POISONING,503,0,796,1299
22,0,GOA,2004,0,ELECTROCUTION,1,0,21,22
11,0,GOA,2004,0,GAS CYLINDER/STOVE BURST,10,0,4,14
0,0,GOA,2004,0,FIRE-ARMS,0,0,0,0
36,0,GOA,2004,0,SUDDEN DEATHS(HEART ATTACKS),8,0,28,36
9,0,GOA,2004,0,EPILEPTIC FITS/GIDDINESS,2,0,7,9
0,0,GOA,2004,0,ABORTIONS/CHILD BIRTH,0,0,0,0
13,0,GOA,2004,0,INFLUENCE OF ALCOHOL,1,0,12,13
0,0,GOA,2004,0,FOOD POISIONING/ACCIDENTAL INTAKE OF INSECTICIDES ETC.,0,0,0,0
5,0,GOA,2004,0,SNAKE BITE/ANIMAL BITE,3,0,2,5
6,0,GOA,2004,0,OTHER,2,0,4,6
26,0,GOA,2004,0,OTHER RAILWAY ACCIDENTS,2,0,24,26
65,0,GOA,2004,0,OTHER,20,0,46,66
163,0,GOA,2004,0,DROWNING,14,0,152,166
86,0,GOA,2004,0,FALLS,8,0,78,86
50,0,GOA,2004,0,FIRE,38,0,15,53
58,0,GOA,2004,0,SUDDEN DEATHS,11,0,47,58
11,0,GOA,2004,0,POISONING,5,0,6,11
488,11,GUJARAT,2004,13,ELECTROCUTION,105,2,378,483
586,18,GUJARAT,2004,69,GAS CYLINDER/STOVE BURST,410,51,113,523
1,1,GUJARAT,2004,1,FIRE-ARMS,0,0,0,0
1068,0,GUJARAT,2004,0,SUDDEN DEATHS(HEART ATTACKS),119,0,949,1068
436,0,GUJARAT,2004,0,EPILEPTIC FITS/GIDDINESS,68,0,368,436
26,0,GUJARAT,2004,0,ABORTIONS/CHILD BIRTH,24,0,2,26
32,0,GUJARAT,2004,0,INFLUENCE OF ALCOHOL,2,0,32,34
402,39,GUJARAT,2004,63,FOOD POISIONING/ACCIDENTAL INTAKE OF INSECTICIDES ETC.,128,24,211,339
548,60,GUJARAT,2004,108,SNAKE BITE/ANIMAL BITE,174,48,266,440
262,7,GUJARAT,2004,7,OTHER,80,0,176,256
1048,0,GUJARAT,2004,0,OTHER RAILWAY ACCIDENTS,116,0,932,1048
1707,7,GUJARAT,2004,13,OTHER,361,6,1336,1697
1368,1,GUJARAT,2004,1,DROWNING,264,0,1142,1406
936,48,GUJARAT,2004,56,FALLS,145,8,738,883
2276,31,GUJARAT,2004,90,FIRE,1569,59,639,2208
1562,0,GUJARAT,2004,0,SUDDEN DEATHS,213,0,1351,1564
1276,108,GUJARAT,2004,182,POISONING,395,74,703,1098
186,0,HARYANA,2004,0,ELECTROCUTION,14,0,172,186
144,0,HARYANA,2004,0,GAS CYLINDER/STOVE BURST,96,0,48,144
13,1,HARYANA,2004,1,FIRE-ARMS,1,0,9,10
257,0,HARYANA,2004,0,SUDDEN DEATHS(HEART ATTACKS),26,0,231,257
57,0,HARYANA,2004,0,EPILEPTIC FITS/GIDDINESS,4,0,53,57
19,0,HARYANA,2004,0,ABORTIONS/CHILD BIRTH,19,0,0,19
92,0,HARYANA,2004,0,INFLUENCE OF ALCOHOL,0,0,92,92
273,0,HARYANA,2004,0,FOOD POISIONING/ACCIDENTAL INTAKE OF INSECTICIDES ETC.,75,0,201,276
42,0,HARYANA,2004,0,SNAKE BITE/ANIMAL BITE,2,0,40,42
411,0,HARYANA,2004,0,OTHER,90,0,321,411
1293,0,HARYANA,2004,0,OTHER RAILWAY ACCIDENTS,147,0,1146,1293
483,2,HARYANA,2004,2,OTHER,71,0,416,487
300,0,HARYANA,2004,0,DROWNING,49,0,251,300
194,0,HARYANA,2004,0,FALLS,23,0,171,194
319,0,HARYANA,2004,0,FIRE,172,0,148,320
425,0,HARYANA,2004,0,SUDDEN DEATHS,49,0,376,425
774,0,HARYANA,2004,0,POISONING,169,0,608,777
12,0,HIMACHAL PRADESH,2004,0,ELECTROCUTION,2,0,11,13
4,0,HIMACHAL PRADESH,2004,0,GAS CYLINDER/STOVE BURST,4,0,0,4
1,0,HIMACHAL PRADESH,2004,0,FIRE-ARMS,0,0,1,1
123,0,HIMACHAL PRADESH,2004,0,SUDDEN DEATHS(HEART ATTACKS),11,0,112,123
13,0,HIMACHAL PRADESH,2004,0,EPILEPTIC FITS/GIDDINESS,1,0,12,13
0,0,HIMACHAL PRADESH,2004,0,ABORTIONS/CHILD BIRTH,0,0,0,0
49,0,HIMACHAL PRADESH,2004,0,INFLUENCE OF ALCOHOL,0,0,49,49
93,0,HIMACHAL PRADESH,2004,0,FOOD POISIONING/ACCIDENTAL INTAKE OF INSECTICIDES ETC.,33,0,60,93
6,0,HIMACHAL PRADESH,2004,0,SNAKE BITE/ANIMAL BITE,1,0,5,6
91,0,HIMACHAL PRADESH,2004,0,OTHER,16,0,75,91
18,0,HIMACHAL PRADESH,2004,0,OTHER RAILWAY ACCIDENTS,1,0,17,18
71,1,HIMACHAL PRADESH,2004,2,OTHER,5,1,68,73
106,0,HIMACHAL PRADESH,2004,0,DROWNING,14,0,93,107
180,0,HIMACHAL PRADESH,2004,0,FALLS,17,0,163,180
39,1,HIMACHAL PRADESH,2004,1,FIRE,16,0,23,39
185,0,HIMACHAL PRADESH,2004,0,SUDDEN DEATHS,12,0,173,185
194,0,HIMACHAL PRADESH,2004,0,POISONING,50,0,144,194
22,14,JAMMU & KASHMIR,2004,15,ELECTROCUTION,3,1,16,19
14,2,JAMMU & KASHMIR,2004,2,GAS CYLINDER/STOVE BURST,4,0,8,12
509,408,JAMMU & KASHMIR,2004,461,FIRE-ARMS,30,53,342,372
73,0,JAMMU & KASHMIR,2004,0,SUDDEN DEATHS(HEART ATTACKS),12,0,61,73
3,2,JAMMU & KASHMIR,2004,2,EPILEPTIC FITS/GIDDINESS,0,0,1,1
5,0,JAMMU & KASHMIR,2004,0,ABORTIONS/CHILD BIRTH,5,0,0,5
8,1,JAMMU & KASHMIR,2004,1,INFLUENCE OF ALCOHOL,0,0,7,7
19,2,JAMMU & KASHMIR,2004,2,FOOD POISIONING/ACCIDENTAL INTAKE OF INSECTICIDES ETC.,12,0,6,18
5,0,JAMMU & KASHMIR,2004,0,SNAKE BITE/ANIMAL BITE,1,0,4,5
19,10,JAMMU & KASHMIR,2004,13,OTHER,9,3,10,19
0,0,JAMMU & KASHMIR,2004,0,OTHER RAILWAY ACCIDENTS,0,0,0,0
60,2,JAMMU & KASHMIR,2004,2,OTHER,11,0,59,70
27,2,JAMMU & KASHMIR,2004,2,DROWNING,7,0,20,27
42,4,JAMMU & KASHMIR,2004,6,FALLS,10,2,31,41
31,5,JAMMU & KASHMIR,2004,5,FIRE,10,0,13,23
89,3,JAMMU & KASHMIR,2004,3,SUDDEN DEATHS,17,0,69,86
45,14,JAMMU & KASHMIR,2004,17,POISONING,22,3,20,42
15,0,JHARKHAND,2004,0,ELECTROCUTION,3,0,12,15
28,0,JHARKHAND,2004,0,GAS CYLINDER/STOVE BURST,20,0,8,28
1,1,JHARKHAND,2004,1,FIRE-ARMS,0,0,1,1
15,0,JHARKHAND,2004,0,SUDDEN DEATHS(HEART ATTACKS),4,0,11,15
3,0,JHARKHAND,2004,0,EPILEPTIC FITS/GIDDINESS,1,0,2,3
4,0,JHARKHAND,2004,0,ABORTIONS/CHILD BIRTH,4,0,0,4
22,1,JHARKHAND,2004,2,INFLUENCE OF ALCOHOL,6,1,14,20
10,0,JHARKHAND,2004,0,FOOD POISIONING/ACCIDENTAL INTAKE OF INSECTICIDES ETC.,3,0,7,10
18,1,JHARKHAND,2004,3,SNAKE BITE/ANIMAL BITE,6,2,9,15
0,0,JHARKHAND,2004,0,OTHER,0,0,0,0
142,75,JHARKHAND,2004,147,OTHER RAILWAY ACCIDENTS,19,72,118,137
72,5,JHARKHAND,2004,7,OTHER,36,2,53,89
30,2,JHARKHAND,2004,2,DROWNING,4,0,26,30
48,3,JHARKHAND,2004,4,FALLS,10,1,36,46
120,3,JHARKHAND,2004,5,FIRE,77,2,42,119
44,1,JHARKHAND,2004,2,SUDDEN DEATHS,15,1,27,42
38,2,JHARKHAND,2004,4,POISONING,13,2,21,34
288,9,KARNATAKA,2004,9,ELECTROCUTION,29,0,263,292
227,0,KARNATAKA,2004,4,GAS CYLINDER/STOVE BURST,182,4,47,229
9,0,KARNATAKA,2004,0,FIRE-ARMS,4,0,5,9
407,0,KARNATAKA,2004,0,SUDDEN DEATHS(HEART ATTACKS),36,0,374,410
36,0,KARNATAKA,2004,0,EPILEPTIC FITS/GIDDINESS,6,0,36,42
2,0,KARNATAKA,2004,0,ABORTIONS/CHILD BIRTH,2,0,0,2
265,0,KARNATAKA,2004,0,INFLUENCE OF ALCOHOL,10,0,259,269
119,0,KARNATAKA,2004,0,FOOD POISIONING/ACCIDENTAL INTAKE OF INSECTICIDES ETC.,44,0,77,121
438,2,KARNATAKA,2004,2,SNAKE BITE/ANIMAL BITE,150,0,295,445
1087,0,KARNATAKA,2004,0,OTHER,326,0,759,1085
655,0,KARNATAKA,2004,0,OTHER RAILWAY ACCIDENTS,118,0,537,655
834,32,KARNATAKA,2004,84,OTHER,159,52,504,663
1434,15,KARNATAKA,2004,25,DROWNING,446,10,1039,1485
411,8,KARNATAKA,2004,13,FALLS,31,5,385,416
1207,3,KARNATAKA,2004,7,FIRE,812,4,387,1199
710,0,KARNATAKA,2004,0,SUDDEN DEATHS,54,0,669,723
1667,2,KARNATAKA,2004,2,POISONING,525,0,1149,1674
158,2,KERALA,2004,2,ELECTROCUTION,27,0,130,157
23,0,KERALA,2004,3,GAS CYLINDER/STOVE BURST,20,3,4,24
0,0,KERALA,2004,0,FIRE-ARMS,0,0,0,0
688,0,KERALA,2004,0,SUDDEN DEATHS(HEART ATTACKS),58,0,630,688
61,0,KERALA,2004,0,EPILEPTIC FITS/GIDDINESS,13,0,48,61
11,0,KERALA,2004,0,ABORTIONS/CHILD BIRTH,11,0,0,11
68,6,KERALA,2004,6,INFLUENCE OF ALCOHOL,0,0,68,68
26,0,KERALA,2004,0,FOOD POISIONING/ACCIDENTAL INTAKE OF INSECTICIDES ETC.,10,0,16,26
29,1,KERALA,2004,1,SNAKE BITE/ANIMAL BITE,5,0,23,28
144,2,KERALA,2004,6,OTHER,26,4,114,140
261,6,KERALA,2004,9,OTHER RAILWAY ACCIDENTS,43,3,212,255
633,3,KERALA,2004,3,OTHER,124,0,511,635
1319,14,KERALA,2004,19,DROWNING,287,5,1065,1352
535,15,KERALA,2004,22,FALLS,35,7,500,535
238,2,KERALA,2004,6,FIRE,166,4,76,242
828,6,KERALA,2004,6,SUDDEN DEATHS,82,0,746,828
200,16,KERALA,2004,20,POISONING,41,4,156,197
1011,17,MADHYA PRADESH,2004,25,ELECTROCUTION,192,8,803,995
192,3,MADHYA PRADESH,2004,10,GAS CYLINDER/STOVE BURST,147,7,42,189
156,49,MADHYA PRADESH,2004,51,FIRE-ARMS,10,2,99,109
642,0,MADHYA PRADESH,2004,0,SUDDEN DEATHS(HEART ATTACKS),104,0,538,642
106,0,MADHYA PRADESH,2004,0,EPILEPTIC FITS/GIDDINESS,35,0,73,108
117,0,MADHYA PRADESH,2004,0,ABORTIONS/CHILD BIRTH,117,0,0,117
278,5,MADHYA PRADESH,2004,5,INFLUENCE OF ALCOHOL,7,0,268,275
2132,59,MADHYA PRADESH,2004,75,FOOD POISIONING/ACCIDENTAL INTAKE OF INSECTICIDES ETC.,870,16,1255,2125
1626,25,MADHYA PRADESH,2004,52,SNAKE BITE/ANIMAL BITE,645,27,937,1582
364,3,MADHYA PRADESH,2004,6,OTHER,143,3,221,364
1261,0,MADHYA PRADESH,2004,0,OTHER RAILWAY ACCIDENTS,165,0,1096,1261
3961,492,MADHYA PRADESH,2004,508,OTHER,1040,16,2849,3889
3584,37,MADHYA PRADESH,2004,57,DROWNING,1249,20,2335,3584
747,16,MADHYA PRADESH,2004,24,FALLS,159,8,572,731
1931,38,MADHYA PRADESH,2004,88,FIRE,1356,50,527,1883
1143,5,MADHYA PRADESH,2004,5,SUDDEN DEATHS,263,0,879,1142
4172,89,MADHYA PRADESH,2004,135,POISONING,1670,46,2449,4119
1047,60,MAHARASHTRA,2004,83,ELECTROCUTION,122,23,853,975
157,12,MAHARASHTRA,2004,13,GAS CYLINDER/STOVE BURST,122,1,28,150
16,2,MAHARASHTRA,2004,2,FIRE-ARMS,0,0,17,17
4428,120,MAHARASHTRA,2004,148,SUDDEN DEATHS(HEART ATTACKS),651,28,3629,4280
1413,217,MAHARASHTRA,2004,295,EPILEPTIC FITS/GIDDINESS,254,78,864,1118
267,0,MAHARASHTRA,2004,1,ABORTIONS/CHILD BIRTH,266,1,0,266
1211,83,MAHARASHTRA,2004,88,INFLUENCE OF ALCOHOL,19,5,1104,1123
2842,843,MAHARASHTRA,2004,1523,FOOD POISIONING/ACCIDENTAL INTAKE OF INSECTICIDES ETC.,466,680,1021,1487
1572,331,MAHARASHTRA,2004,556,SNAKE BITE/ANIMAL BITE,341,225,684,1025
37,13,MAHARASHTRA,2004,18,OTHER,8,5,17,25
7696,2487,MAHARASHTRA,2004,2808,OTHER RAILWAY ACCIDENTS,533,321,4367,4900
12668,214,MAHARASHTRA,2004,267,OTHER,2913,53,9746,12659
4644,24,MAHARASHTRA,2004,36,DROWNING,1414,12,3305,4719
2589,458,MAHARASHTRA,2004,624,FALLS,302,166,1703,2005
5661,511,MAHARASHTRA,2004,1164,FIRE,3362,653,1317,4679
7319,420,MAHARASHTRA,2004,532,SUDDEN DEATHS,1190,112,5597,6787
4541,1187,MAHARASHTRA,2004,2097,POISONING,817,910,1810,2627
10,0,MANIPUR,2004,0,ELECTROCUTION,1,0,10,11
0,0,MANIPUR,2004,0,GAS CYLINDER/STOVE BURST,0,0,0,0
1,1,MANIPUR,2004,1,FIRE-ARMS,0,0,1,1
10,0,MANIPUR,2004,0,SUDDEN DEATHS(HEART ATTACKS),1,0,9,10
0,0,MANIPUR,2004,0,EPILEPTIC FITS/GIDDINESS,0,0,0,0
0,0,MANIPUR,2004,0,ABORTIONS/CHILD BIRTH,0,0,0,0
0,0,MANIPUR,2004,0,INFLUENCE OF ALCOHOL,0,0,0,0
0,0,MANIPUR,2004,0,FOOD POISIONING/ACCIDENTAL INTAKE OF INSECTICIDES ETC.,0,0,0,0
0,0,MANIPUR,2004,0,SNAKE BITE/ANIMAL BITE,0,0,0,0
15,0,MANIPUR,2004,0,OTHER,1,0,14,15
0,0,MANIPUR,2004,0,OTHER RAILWAY ACCIDENTS,0,0,0,0
1,0,MANIPUR,2004,0,OTHER,0,0,1,1
16,0,MANIPUR,2004,0,DROWNING,2,0,14,16
2,0,MANIPUR,2004,0,FALLS,0,0,2,2
3,0,MANIPUR,2004,0,FIRE,3,0,0,3
10,0,MANIPUR,2004,0,SUDDEN DEATHS,1,0,9,10
15,0,MANIPUR,2004,0,POISONING,1,0,14,15
9,0,MEGHALAYA,2004,0,ELECTROCUTION,1,0,8,9
1,1,MEGHALAYA,2004,1,GAS CYLINDER/STOVE BURST,0,0,1,1
10,0,MEGHALAYA,2004,0,FIRE-ARMS,0,0,10,10
5,0,MEGHALAYA,2004,0,SUDDEN DEATHS(HEART ATTACKS),0,0,5,5
10,0,MEGHALAYA,2004,0,EPILEPTIC FITS/GIDDINESS,1,0,9,10
0,0,MEGHALAYA,2004,0,ABORTIONS/CHILD BIRTH,0,0,0,0
3,0,MEGHALAYA,2004,0,INFLUENCE OF ALCOHOL,0,0,3,3
0,0,MEGHALAYA,2004,0,FOOD POISIONING/ACCIDENTAL INTAKE OF INSECTICIDES ETC.,0,0,0,0
0,0,MEGHALAYA,2004,0,SNAKE BITE/ANIMAL BITE,0,0,0,0
0,0,MEGHALAYA,2004,0,OTHER,0,0,0,0
0,0,MEGHALAYA,2004,0,OTHER RAILWAY ACCIDENTS,0,0,0,0
3,0,MEGHALAYA,2004,0,OTHER,0,0,3,3
18,4,MEGHALAYA,2004,4,DROWNING,1,0,17,18
13,0,MEGHALAYA,2004,0,FALLS,1,0,12,13
10,1,MEGHALAYA,2004,1,FIRE,5,0,5,10
18,0,MEGHALAYA,2004,0,SUDDEN DEATHS,1,0,17,18
0,0,MEGHALAYA,2004,0,POISONING,0,0,0,0
5,0,MIZORAM,2004,0,ELECTROCUTION,0,0,5,5
1,0,MIZORAM,2004,0,GAS CYLINDER/STOVE BURST,2,0,0,2
0,0,MIZORAM,2004,0,FIRE-ARMS,0,0,0,0
0,0,MIZORAM,2004,0,SUDDEN DEATHS(HEART ATTACKS),0,0,0,0
0,0,MIZORAM,2004,0,EPILEPTIC FITS/GIDDINESS,0,0,0,0
0,0,MIZORAM,2004,0,ABORTIONS/CHILD BIRTH,0,0,0,0
3,0,MIZORAM,2004,0,INFLUENCE OF ALCOHOL,1,0,2,3
0,0,MIZORAM,2004,0,FOOD POISIONING/ACCIDENTAL INTAKE OF INSECTICIDES ETC.,0,0,0,0
2,0,MIZORAM,2004,0,SNAKE BITE/ANIMAL BITE,0,0,2,2
0,0,MIZORAM,2004,0,OTHER,0,0,0,0
0,0,MIZORAM,2004,0,OTHER RAILWAY ACCIDENTS,0,0,0,0
15,21,MIZORAM,2004,39,OTHER,4,18,12,16
21,0,MIZORAM,2004,0,DROWNING,2,0,19,21
12,0,MIZORAM,2004,0,FALLS,1,0,11,12
3,0,MIZORAM,2004,0,FIRE,2,0,2,4
3,0,MIZORAM,2004,0,SUDDEN DEATHS,1,0,2,3
4,1,MIZORAM,2004,2,POISONING,0,1,2,2
1,0,NAGALAND,2004,0,ELECTROCUTION,0,0,1,1
0,0,NAGALAND,2004,0,GAS CYLINDER/STOVE BURST,0,0,0,0
0,0,NAGALAND,2004,0,FIRE-ARMS,0,0,0,0
0,0,NAGALAND,2004,0,SUDDEN DEATHS(HEART ATTACKS),0,0,0,0
0,0,NAGALAND,2004,0,EPILEPTIC FITS/GIDDINESS,0,0,0,0
0,0,NAGALAND,2004,0,ABORTIONS/CHILD BIRTH,0,0,0,0
0,0,NAGALAND,2004,0,INFLUENCE OF ALCOHOL,0,0,0,0
0,0,NAGALAND,2004,0,FOOD POISIONING/ACCIDENTAL INTAKE OF INSECTICIDES ETC.,0,0,0,0
0,0,NAGALAND,2004,0,SNAKE BITE/ANIMAL BITE,0,0,0,0
0,0,NAGALAND,2004,0,OTHER,0,0,0,0
1,0,NAGALAND,2004,0,OTHER RAILWAY ACCIDENTS,0,0,1,1
1,0,NAGALAND,2004,0,OTHER,0,0,1,1
4,0,NAGALAND,2004,0,DROWNING,1,0,3,4
0,0,NAGALAND,2004,0,FALLS,0,0,0,0
0,0,NAGALAND,2004,0,FIRE,0,0,0,0
0,0,NAGALAND,2004,0,SUDDEN DEATHS,0,0,0,0
0,0,NAGALAND,2004,0,POISONING,0,0,0,0
154,10,ODISHA,2004,12,ELECTROCUTION,25,2,131,156
28,0,ODISHA,2004,0,GAS CYLINDER/STOVE BURST,25,0,4,29
6,0,ODISHA,2004,0,FIRE-ARMS,0,0,6,6
121,0,ODISHA,2004,0,SUDDEN DEATHS(HEART ATTACKS),33,0,88,121
32,0,ODISHA,2004,1,EPILEPTIC FITS/GIDDINESS,7,1,25,32
12,0,ODISHA,2004,0,ABORTIONS/CHILD BIRTH,12,0,0,12
43,1,ODISHA,2004,1,INFLUENCE OF ALCOHOL,4,0,39,43
358,4,ODISHA,2004,15,FOOD POISIONING/ACCIDENTAL INTAKE OF INSECTICIDES ETC.,124,11,232,356
426,6,ODISHA,2004,9,SNAKE BITE/ANIMAL BITE,163,3,265,428
350,19,ODISHA,2004,40,OTHER,117,21,235,352
384,0,ODISHA,2004,0,OTHER RAILWAY ACCIDENTS,57,0,327,384
558,0,ODISHA,2004,5,OTHER,182,5,376,558
562,30,ODISHA,2004,41,DROWNING,198,11,386,584
256,5,ODISHA,2004,5,FALLS,54,0,204,258
354,14,ODISHA,2004,27,FIRE,192,13,174,366
208,1,ODISHA,2004,2,SUDDEN DEATHS,56,1,152,208
1142,29,ODISHA,2004,64,POISONING,405,35,742,1147
206,0,PUNJAB,2004,0,ELECTROCUTION,8,0,198,206
137,0,PUNJAB,2004,0,GAS CYLINDER/STOVE BURST,96,0,41,137
18,0,PUNJAB,2004,0,FIRE-ARMS,1,0,17,18
264,0,PUNJAB,2004,0,SUDDEN DEATHS(HEART ATTACKS),30,0,234,264
57,0,PUNJAB,2004,0,EPILEPTIC FITS/GIDDINESS,11,0,46,57
5,0,PUNJAB,2004,0,ABORTIONS/CHILD BIRTH,5,0,0,5
147,0,PUNJAB,2004,0,INFLUENCE OF ALCOHOL,0,0,147,147
244,0,PUNJAB,2004,0,FOOD POISIONING/ACCIDENTAL INTAKE OF INSECTICIDES ETC.,56,0,188,244
37,0,PUNJAB,2004,0,SNAKE BITE/ANIMAL BITE,5,0,32,37
293,0,PUNJAB,2004,0,OTHER,79,0,214,293
682,27,PUNJAB,2004,28,OTHER RAILWAY ACCIDENTS,88,1,631,719
336,0,PUNJAB,2004,0,OTHER,50,0,286,336
423,0,PUNJAB,2004,0,DROWNING,373,0,50,423
122,0,PUNJAB,2004,0,FALLS,9,0,113,122
290,0,PUNJAB,2004,0,FIRE,164,0,126,290
473,0,PUNJAB,2004,0,SUDDEN DEATHS,46,0,427,473
686,0,PUNJAB,2004,0,POISONING,188,0,498,686
370,0,RAJASTHAN,2004,0,ELECTROCUTION,46,0,336,382
101,1,RAJASTHAN,2004,2,GAS CYLINDER/STOVE BURST,72,1,29,101
3,0,RAJASTHAN,2004,0,FIRE-ARMS,0,0,4,4
409,0,RAJASTHAN,2004,0,SUDDEN DEATHS(HEART ATTACKS),67,0,342,409
79,0,RAJASTHAN,2004,0,EPILEPTIC FITS/GIDDINESS,21,0,58,79
35,0,RAJASTHAN,2004,0,ABORTIONS/CHILD BIRTH,35,0,0,35
183,0,RAJASTHAN,2004,0,INFLUENCE OF ALCOHOL,3,0,180,183
1101,0,RAJASTHAN,2004,0,FOOD POISIONING/ACCIDENTAL INTAKE OF INSECTICIDES ETC.,354,0,761,1115
93,2,RAJASTHAN,2004,2,SNAKE BITE/ANIMAL BITE,18,0,75,93
84,0,RAJASTHAN,2004,0,OTHER,27,0,57,84
278,0,RAJASTHAN,2004,0,OTHER RAILWAY ACCIDENTS,42,0,273,315
1498,0,RAJASTHAN,2004,0,OTHER,333,0,1171,1504
1293,7,RAJASTHAN,2004,9,DROWNING,388,2,962,1350
571,0,RAJASTHAN,2004,0,FALLS,116,0,457,573
732,4,RAJASTHAN,2004,6,FIRE,440,2,303,743
706,0,RAJASTHAN,2004,0,SUDDEN DEATHS,126,0,580,706
1290,2,RAJASTHAN,2004,2,POISONING,399,0,906,1305
9,0,SIKKIM,2004,0,ELECTROCUTION,0,0,9,9
7,0,SIKKIM,2004,0,GAS CYLINDER/STOVE BURST,6,0,1,7
2,0,SIKKIM,2004,0,FIRE-ARMS,0,0,2,2
10,0,SIKKIM,2004,0,SUDDEN DEATHS(HEART ATTACKS),3,0,7,10
4,0,SIKKIM,2004,0,EPILEPTIC FITS/GIDDINESS,1,0,3,4
0,0,SIKKIM,2004,0,ABORTIONS/CHILD BIRTH,0,0,0,0
5,0,SIKKIM,2004,0,INFLUENCE OF ALCOHOL,0,0,5,5
0,0,SIKKIM,2004,0,FOOD POISIONING/ACCIDENTAL INTAKE OF INSECTICIDES ETC.,0,0,0,0
0,0,SIKKIM,2004,0,SNAKE BITE/ANIMAL BITE,0,0,0,0
33,0,SIKKIM,2004,0,OTHER,6,0,27,33
0,0,SIKKIM,2004,0,OTHER RAILWAY ACCIDENTS,0,0,0,0
0,0,SIKKIM,2004,0,OTHER,0,0,0,0
10,0,SIKKIM,2004,0,DROWNING,3,0,7,10
26,0,SIKKIM,2004,0,FALLS,3,0,23,26
9,0,SIKKIM,2004,0,FIRE,6,0,3,9
19,0,SIKKIM,2004,0,SUDDEN DEATHS,4,0,15,19
33,0,SIKKIM,2004,0,POISONING,6,0,27,33
272,1,TAMIL NADU,2004,2,ELECTROCUTION,46,1,230,276
704,48,TAMIL NADU,2004,63,GAS CYLINDER/STOVE BURST,587,15,135,722
4,2,TAMIL NADU,2004,4,FIRE-ARMS,0,2,0,0
613,23,TAMIL NADU,2004,32,SUDDEN DEATHS(HEART ATTACKS),93,9,515,608
109,0,TAMIL NADU,2004,0,EPILEPTIC FITS/GIDDINESS,31,0,79,110
10,0,TAMIL NADU,2004,0,ABORTIONS/CHILD BIRTH,10,0,0,10
116,6,TAMIL NADU,2004,6,INFLUENCE OF ALCOHOL,3,0,109,112
230,6,TAMIL NADU,2004,14,FOOD POISIONING/ACCIDENTAL INTAKE OF INSECTICIDES ETC.,69,8,155,224
316,9,TAMIL NADU,2004,17,SNAKE BITE/ANIMAL BITE,108,8,192,300
930,3,TAMIL NADU,2004,5,OTHER,325,2,608,933
0,0,TAMIL NADU,2004,0,OTHER RAILWAY ACCIDENTS,0,0,0,0
668,27,TAMIL NADU,2004,41,OTHER,215,14,478,693
945,11,TAMIL NADU,2004,12,DROWNING,247,1,765,1012
378,29,TAMIL NADU,2004,30,FALLS,48,1,330,378
1732,63,TAMIL NADU,2004,95,FIRE,1240,32,549,1789
848,29,TAMIL NADU,2004,38,SUDDEN DEATHS,137,9,703,840
1529,18,TAMIL NADU,2004,36,POISONING,520,18,993,1513
2,0,TRIPURA,2004,0,ELECTROCUTION,0,0,2,2
0,0,TRIPURA,2004,0,GAS CYLINDER/STOVE BURST,0,0,0,0
2,0,TRIPURA,2004,0,FIRE-ARMS,0,0,2,2
31,0,TRIPURA,2004,0,SUDDEN DEATHS(HEART ATTACKS),10,0,21,31
0,0,TRIPURA,2004,0,EPILEPTIC FITS/GIDDINESS,0,0,0,0
2,0,TRIPURA,2004,0,ABORTIONS/CHILD BIRTH,2,0,0,2
3,0,TRIPURA,2004,0,INFLUENCE OF ALCOHOL,0,0,3,3
127,0,TRIPURA,2004,0,FOOD POISIONING/ACCIDENTAL INTAKE OF INSECTICIDES ETC.,62,0,65,127
0,0,TRIPURA,2004,0,SNAKE BITE/ANIMAL BITE,0,0,0,0
0,0,TRIPURA,2004,0,OTHER,0,0,0,0
0,0,TRIPURA,2004,0,OTHER RAILWAY ACCIDENTS,0,0,0,0
3,0,TRIPURA,2004,0,OTHER,2,0,1,3
68,0,TRIPURA,2004,0,DROWNING,31,0,38,69
10,0,TRIPURA,2004,0,FALLS,3,0,7,10
17,0,TRIPURA,2004,0,FIRE,10,0,8,18
36,0,TRIPURA,2004,0,SUDDEN DEATHS,12,0,24,36
127,0,TRIPURA,2004,0,POISONING,62,0,65,127
414,82,UTTAR PRADESH,2004,102,ELECTROCUTION,61,20,325,386
150,20,UTTAR PRADESH,2004,47,GAS CYLINDER/STOVE BURST,91,27,36,127
2342,936,UTTAR PRADESH,2004,1079,FIRE-ARMS,234,143,1356,1590
259,17,UTTAR PRADESH,2004,18,SUDDEN DEATHS(HEART ATTACKS),41,1,209,250
65,0,UTTAR PRADESH,2004,0,EPILEPTIC FITS/GIDDINESS,26,0,53,79
69,0,UTTAR PRADESH,2004,0,ABORTIONS/CHILD BIRTH,69,0,0,69
109,21,UTTAR PRADESH,2004,24,INFLUENCE OF ALCOHOL,5,3,115,120
527,43,UTTAR PRADESH,2004,68,FOOD POISIONING/ACCIDENTAL INTAKE OF INSECTICIDES ETC.,239,25,262,501
66,3,UTTAR PRADESH,2004,4,SNAKE BITE/ANIMAL BITE,20,1,50,70
284,32,UTTAR PRADESH,2004,50,OTHER,102,18,163,265
2450,131,UTTAR PRADESH,2004,158,OTHER RAILWAY ACCIDENTS,416,27,2054,2470
1856,329,UTTAR PRADESH,2004,414,OTHER,305,85,1427,1732
557,73,UTTAR PRADESH,2004,105,DROWNING,177,32,436,613
225,42,UTTAR PRADESH,2004,61,FALLS,44,19,147,191
920,136,UTTAR PRADESH,2004,260,FIRE,586,124,286,872
502,38,UTTAR PRADESH,2004,42,SUDDEN DEATHS,141,4,377,518
932,88,UTTAR PRADESH,2004,135,POISONING,368,47,522,890
24,1,UTTARAKHAND,2004,1,ELECTROCUTION,6,0,22,28
16,1,UTTARAKHAND,2004,1,GAS CYLINDER/STOVE BURST,10,0,5,15
19,1,UTTARAKHAND,2004,2,FIRE-ARMS,1,1,16,17
47,0,UTTARAKHAND,2004,0,SUDDEN DEATHS(HEART ATTACKS),11,0,36,47
9,0,UTTARAKHAND,2004,0,EPILEPTIC FITS/GIDDINESS,1,0,8,9
3,0,UTTARAKHAND,2004,1,ABORTIONS/CHILD BIRTH,2,1,0,2
16,0,UTTARAKHAND,2004,0,INFLUENCE OF ALCOHOL,0,0,16,16
113,1,UTTARAKHAND,2004,1,FOOD POISIONING/ACCIDENTAL INTAKE OF INSECTICIDES ETC.,29,0,84,113
5,1,UTTARAKHAND,2004,1,SNAKE BITE/ANIMAL BITE,1,0,3,4
18,3,UTTARAKHAND,2004,3,OTHER,5,0,10,15
10,0,UTTARAKHAND,2004,0,OTHER RAILWAY ACCIDENTS,2,0,8,10
78,3,UTTARAKHAND,2004,6,OTHER,9,3,63,72
89,1,UTTARAKHAND,2004,2,DROWNING,24,1,67,91
77,2,UTTARAKHAND,2004,3,FALLS,14,1,68,82
74,5,UTTARAKHAND,2004,5,FIRE,47,0,26,73
75,0,UTTARAKHAND,2004,1,SUDDEN DEATHS,14,1,60,74
136,5,UTTARAKHAND,2004,5,POISONING,35,0,97,132
117,27,WEST BENGAL,2004,32,ELECTROCUTION,23,5,99,122
121,6,WEST BENGAL,2004,20,GAS CYLINDER/STOVE BURST,65,14,39,104
42,25,WEST BENGAL,2004,30,FIRE-ARMS,5,5,42,47
656,134,WEST BENGAL,2004,192,SUDDEN DEATHS(HEART ATTACKS),108,58,361,469
3,1,WEST BENGAL,2004,1,EPILEPTIC FITS/GIDDINESS,0,0,2,2
20,0,WEST BENGAL,2004,2,ABORTIONS/CHILD BIRTH,18,2,0,18
93,22,WEST BENGAL,2004,23,INFLUENCE OF ALCOHOL,4,1,66,70
138,16,WEST BENGAL,2004,30,FOOD POISIONING/ACCIDENTAL INTAKE OF INSECTICIDES ETC.,56,14,76,132
174,16,WEST BENGAL,2004,23,SNAKE BITE/ANIMAL BITE,54,7,105,159
1167,45,WEST BENGAL,2004,64,OTHER,481,19,661,1142
1185,0,WEST BENGAL,2004,0,OTHER RAILWAY ACCIDENTS,326,0,859,1185
565,68,WEST BENGAL,2004,107,OTHER,126,39,347,473
466,119,WEST BENGAL,2004,196,DROWNING,112,77,300,412
193,28,WEST BENGAL,2004,35,FALLS,38,7,135,173
573,68,WEST BENGAL,2004,113,FIRE,324,45,224,548
772,157,WEST BENGAL,2004,218,SUDDEN DEATHS,130,61,429,559
1493,82,WEST BENGAL,2004,122,POISONING,594,40,848,1442
4,0,A & N ISLANDS,2004,0,ELECTROCUTION,0,0,4,4
12,0,A & N ISLANDS,2004,0,GAS CYLINDER/STOVE BURST,11,0,1,12
0,0,A & N ISLANDS,2004,0,FIRE-ARMS,0,0,0,0
37,0,A & N ISLANDS,2004,0,SUDDEN DEATHS(HEART ATTACKS),7,0,30,37
0,0,A & N ISLANDS,2004,0,EPILEPTIC FITS/GIDDINESS,0,0,0,0
1,0,A & N ISLANDS,2004,0,ABORTIONS/CHILD BIRTH,1,0,0,1
0,0,A & N ISLANDS,2004,0,INFLUENCE OF ALCOHOL,0,0,0,0
0,0,A & N ISLANDS,2004,0,FOOD POISIONING/ACCIDENTAL INTAKE OF INSECTICIDES ETC.,0,0,0,0
1,0,A & N ISLANDS,2004,0,SNAKE BITE/ANIMAL BITE,0,0,1,1
3,0,A & N ISLANDS,2004,0,OTHER,2,0,1,3
0,0,A & N ISLANDS,2004,0,OTHER RAILWAY ACCIDENTS,0,0,0,0
36,0,A & N ISLANDS,2004,0,OTHER,10,0,26,36
33,0,A & N ISLANDS,2004,0,DROWNING,6,0,28,34
7,0,A & N ISLANDS,2004,0,FALLS,2,0,5,7
22,0,A & N ISLANDS,2004,0,FIRE,19,0,4,23
38,0,A & N ISLANDS,2004,0,SUDDEN DEATHS,8,0,30,38
4,0,A & N ISLANDS,2004,0,POISONING,2,0,2,4
9,0,CHANDIGARH,2004,0,ELECTROCUTION,3,0,6,9
7,0,CHANDIGARH,2004,0,GAS CYLINDER/STOVE BURST,6,0,1,7
0,0,CHANDIGARH,2004,0,FIRE-ARMS,0,0,0,0
42,0,CHANDIGARH,2004,0,SUDDEN DEATHS(HEART ATTACKS),2,0,40,42
3,0,CHANDIGARH,2004,0,EPILEPTIC FITS/GIDDINESS,0,0,3,3
3,0,CHANDIGARH,2004,0,ABORTIONS/CHILD BIRTH,3,0,0,3
13,0,CHANDIGARH,2004,0,INFLUENCE OF ALCOHOL,0,0,13,13
2,0,CHANDIGARH,2004,0,FOOD POISIONING/ACCIDENTAL INTAKE OF INSECTICIDES ETC.,1,0,1,2
0,0,CHANDIGARH,2004,0,SNAKE BITE/ANIMAL BITE,0,0,0,0
16,0,CHANDIGARH,2004,0,OTHER,4,0,12,16
0,0,CHANDIGARH,2004,0,OTHER RAILWAY ACCIDENTS,0,0,0,0
50,0,CHANDIGARH,2004,0,OTHER,4,0,46,50
6,0,CHANDIGARH,2004,0,DROWNING,4,0,2,6
22,0,CHANDIGARH,2004,0,FALLS,5,0,17,22
25,0,CHANDIGARH,2004,0,FIRE,16,0,9,25
61,0,CHANDIGARH,2004,0,SUDDEN DEATHS,5,0,56,61
18,0,CHANDIGARH,2004,0,POISONING,5,0,13,18
5,0,D & N HAVELI,2004,0,ELECTROCUTION,0,0,5,5
8,0,D & N HAVELI,2004,0,GAS CYLINDER/STOVE BURST,1,0,7,8
0,0,D & N HAVELI,2004,0,FIRE-ARMS,0,0,0,0
14,0,D & N HAVELI,2004,0,SUDDEN DEATHS(HEART ATTACKS),0,0,14,14
0,0,D & N HAVELI,2004,0,EPILEPTIC FITS/GIDDINESS,0,0,0,0
1,0,D & N HAVELI,2004,0,ABORTIONS/CHILD BIRTH,1,0,0,1
4,0,D & N HAVELI,2004,0,INFLUENCE OF ALCOHOL,0,0,4,4
0,0,D & N HAVELI,2004,0,FOOD POISIONING/ACCIDENTAL INTAKE OF INSECTICIDES ETC.,0,0,0,0
6,0,D & N HAVELI,2004,0,SNAKE BITE/ANIMAL BITE,1,0,5,6
0,0,D & N HAVELI,2004,0,OTHER,0,0,0,0
0,0,D & N HAVELI,2004,0,OTHER RAILWAY ACCIDENTS,0,0,0,0
17,0,D & N HAVELI,2004,0,OTHER,3,0,15,18
12,0,D & N HAVELI,2004,0,DROWNING,3,0,9,12
14,0,D & N HAVELI,2004,0,FALLS,2,0,12,14
10,0,D & N HAVELI,2004,0,FIRE,1,0,9,10
19,0,D & N HAVELI,2004,0,SUDDEN DEATHS,1,0,18,19
6,0,D & N HAVELI,2004,0,POISONING,1,0,5,6
4,2,DAMAN & DIU,2004,2,ELECTROCUTION,0,0,4,4
4,0,DAMAN & DIU,2004,0,GAS CYLINDER/STOVE BURST,3,0,1,4
0,0,DAMAN & DIU,2004,0,FIRE-ARMS,0,0,0,0
11,0,DAMAN & DIU,2004,0,SUDDEN DEATHS(HEART ATTACKS),1,0,10,11
0,0,DAMAN & DIU,2004,0,EPILEPTIC FITS/GIDDINESS,0,0,0,0
0,0,DAMAN & DIU,2004,0,ABORTIONS/CHILD BIRTH,0,0,0,0
1,0,DAMAN & DIU,2004,0,INFLUENCE OF ALCOHOL,0,0,1,1
0,0,DAMAN & DIU,2004,0,FOOD POISIONING/ACCIDENTAL INTAKE OF INSECTICIDES ETC.,0,0,0,0
0,0,DAMAN & DIU,2004,0,SNAKE BITE/ANIMAL BITE,0,0,0,0
0,0,DAMAN & DIU,2004,0,OTHER,0,0,0,0
0,0,DAMAN & DIU,2004,0,OTHER RAILWAY ACCIDENTS,0,0,0,0
11,0,DAMAN & DIU,2004,0,OTHER,1,0,10,11
11,0,DAMAN & DIU,2004,0,DROWNING,1,0,10,11
6,0,DAMAN & DIU,2004,0,FALLS,0,0,6,6
9,0,DAMAN & DIU,2004,0,FIRE,8,0,1,9
12,0,DAMAN & DIU,2004,0,SUDDEN DEATHS,1,0,11,12
0,0,DAMAN & DIU,2004,0,POISONING,0,0,0,0
151,8,DELHI(UT),2004,8,ELECTROCUTION,18,0,135,153
130,7,DELHI(UT),2004,7,GAS CYLINDER/STOVE BURST,103,0,30,133
52,20,DELHI(UT),2004,23,FIRE-ARMS,5,3,26,31
174,1,DELHI(UT),2004,3,SUDDEN DEATHS(HEART ATTACKS),18,2,155,173
21,0,DELHI(UT),2004,0,EPILEPTIC FITS/GIDDINESS,2,0,19,21
17,0,DELHI(UT),2004,0,ABORTIONS/CHILD BIRTH,17,0,0,17
85,0,DELHI(UT),2004,0,INFLUENCE OF ALCOHOL,1,0,85,86
80,37,DELHI(UT),2004,95,FOOD POISIONING/ACCIDENTAL INTAKE OF INSECTICIDES ETC.,25,58,54,79
14,0,DELHI(UT),2004,0,SNAKE BITE/ANIMAL BITE,2,0,12,14
127,0,DELHI(UT),2004,0,OTHER,53,0,85,138
761,0,DELHI(UT),2004,0,OTHER RAILWAY ACCIDENTS,86,0,675,761
1103,9,DELHI(UT),2004,12,OTHER,251,3,839,1090
95,2,DELHI(UT),2004,2,DROWNING,12,0,84,96
288,9,DELHI(UT),2004,10,FALLS,46,1,250,296
428,32,DELHI(UT),2004,32,FIRE,253,0,196,449
297,1,DELHI(UT),2004,3,SUDDEN DEATHS,38,2,259,297
229,40,DELHI(UT),2004,102,POISONING,82,62,157,239
0,0,LAKSHADWEEP,2004,0,ELECTROCUTION,0,0,0,0
0,0,LAKSHADWEEP,2004,0,GAS CYLINDER/STOVE BURST,0,0,0,0
0,0,LAKSHADWEEP,2004,0,FIRE-ARMS,0,0,0,0
0,0,LAKSHADWEEP,2004,0,SUDDEN DEATHS(HEART ATTACKS),0,0,0,0
0,0,LAKSHADWEEP,2004,0,EPILEPTIC FITS/GIDDINESS,0,0,0,0
0,0,LAKSHADWEEP,2004,0,ABORTIONS/CHILD BIRTH,0,0,0,0
0,0,LAKSHADWEEP,2004,0,INFLUENCE OF ALCOHOL,0,0,0,0
0,0,LAKSHADWEEP,2004,0,FOOD POISIONING/ACCIDENTAL INTAKE OF INSECTICIDES ETC.,0,0,0,0
0,0,LAKSHADWEEP,2004,0,SNAKE BITE/ANIMAL BITE,0,0,0,0
0,0,LAKSHADWEEP,2004,0,OTHER,0,0,0,0
0,0,LAKSHADWEEP,2004,0,OTHER RAILWAY ACCIDENTS,0,0,0,0
0,0,LAKSHADWEEP,2004,0,OTHER,0,0,0,0
0,0,LAKSHADWEEP,2004,0,DROWNING,0,0,0,0
0,0,LAKSHADWEEP,2004,0,FALLS,0,0,0,0
0,0,LAKSHADWEEP,2004,0,FIRE,0,0,0,0
0,0,LAKSHADWEEP,2004,0,SUDDEN DEATHS,0,0,0,0
0,0,LAKSHADWEEP,2004,0,POISONING,0,0,0,0
22,0,PUDUCHERRY,2004,0,ELECTROCUTION,5,0,17,22
0,0,PUDUCHERRY,2004,0,GAS CYLINDER/STOVE BURST,0,0,0,0
0,0,PUDUCHERRY,2004,0,FIRE-ARMS,0,0,0,0
65,0,PUDUCHERRY,2004,0,SUDDEN DEATHS(HEART ATTACKS),8,0,57,65
68,0,PUDUCHERRY,2004,0,EPILEPTIC FITS/GIDDINESS,11,0,57,68
0,0,PUDUCHERRY,2004,0,ABORTIONS/CHILD BIRTH,0,0,0,0
132,0,PUDUCHERRY,2004,0,INFLUENCE OF ALCOHOL,1,0,131,132
3,0,PUDUCHERRY,2004,0,FOOD POISIONING/ACCIDENTAL INTAKE OF INSECTICIDES ETC.,2,0,1,3
14,0,PUDUCHERRY,2004,0,SNAKE BITE/ANIMAL BITE,6,0,8,14
6,0,PUDUCHERRY,2004,0,OTHER,4,0,2,6
0,0,PUDUCHERRY,2004,0,OTHER RAILWAY ACCIDENTS,0,0,0,0
41,0,PUDUCHERRY,2004,0,OTHER,348,0,201,549
84,0,PUDUCHERRY,2004,0,DROWNING,15,0,66,81
53,0,PUDUCHERRY,2004,0,FALLS,5,0,48,53
40,0,PUDUCHERRY,2004,0,FIRE,28,0,12,40
265,0,PUDUCHERRY,2004,0,SUDDEN DEATHS,20,0,245,265
23,0,PUDUCHERRY,2004,0,POISONING,12,0,11,23
