CASES,MALE KILLED,CAUSE,YEAR,FEMALE INJURED,TOTAL KILLED,STATE/UT,TOTAL INJURED,MALE INJURED,FEMALE KILLED
1318,1213,ELECTROCUTION,2006,0,1353,ANDHRA PRADESH,20,20,140
645,111,GAS CYLINDER/STOVE BURST,2006,9,648,ANDHRA PRADESH,15,6,537
4,6,FIRE-ARMS,2006,0,6,ANDHRA PRADESH,0,0,0
512,404,SUDDEN DEATHS(HEART ATTACKS),2006,1,509,ANDHRA PRADESH,4,3,105
148,115,EPILEPTIC FITS/GIDDINESS,2006,0,145,ANDHRA PRADESH,2,2,30
3,0,ABORTIONS/CHILD BIRTH,2006,0,3,ANDHRA PRADESH,0,0,3
342,319,INFLUENCE OF ALCOHOL,2006,0,346,ANDHRA PRADESH,4,4,27
132,78,FOOD POISIONING/ACCIDENTAL INTAKE OF INSECTICIDES ETC.,2006,0,126,ANDHRA PRADESH,6,6,48
888,675,SNAKE BITE/ANIMAL BITE,2006,0,889,ANDHRA PRADESH,7,7,214
524,314,OTHER,2006,3,481,ANDHRA PRADESH,48,45,167
1958,1723,RAILWAY ACCIDENTS,2006,17,1958,ANDHRA PRADESH,193,176,235
2339,1983,DROWNING,2006,4,2468,ANDHRA PRADESH,42,38,485
1264,1067,FALLS,2006,0,1266,ANDHRA PRADESH,9,9,199
1619,585,FIRE,2006,17,1632,ANDHRA PRADESH,44,27,1047
1005,838,SUDDEN DEATHS,2006,1,1003,ANDHRA PRADESH,10,9,165
1647,1155,POISONING,2006,3,1604,ANDHRA PRADESH,61,58,449
1,1,ELECTROCUTION,2006,0,1,ARUNACHAL PRADESH,0,0,0
0,0,GAS CYLINDER/STOVE BURST,2006,0,0,ARUNACHAL PRADESH,0,0,0
3,3,FIRE-ARMS,2006,0,3,ARUNACHAL PRADESH,0,0,0
6,5,SUDDEN DEATHS(HEART ATTACKS),2006,0,6,ARUNACHAL PRADESH,0,0,1
0,0,EPILEPTIC FITS/GIDDINESS,2006,0,0,ARUNACHAL PRADESH,0,0,0
0,0,ABORTIONS/CHILD BIRTH,2006,0,0,ARUNACHAL PRADESH,0,0,0
1,1,INFLUENCE OF ALCOHOL,2006,0,1,ARUNACHAL PRADESH,0,0,0
0,0,FOOD POISIONING/ACCIDENTAL INTAKE OF INSECTICIDES ETC.,2006,0,0,ARUNACHAL PRADESH,0,0,0
0,0,SNAKE BITE/ANIMAL BITE,2006,0,0,ARUNACHAL PRADESH,0,0,0
1,1,OTHER,2006,0,1,ARUNACHAL PRADESH,0,0,0
0,0,RAILWAY ACCIDENTS,2006,0,0,ARUNACHAL PRADESH,0,0,0
14,11,DROWNING,2006,0,15,ARUNACHAL PRADESH,0,0,4
15,14,FALLS,2006,0,15,ARUNACHAL PRADESH,0,0,1
5,7,FIRE,2006,0,7,ARUNACHAL PRADESH,0,0,0
7,6,SUDDEN DEATHS,2006,0,7,ARUNACHAL PRADESH,0,0,1
1,1,POISONING,2006,0,1,ARUNACHAL PRADESH,0,0,0
62,47,ELECTROCUTION,2006,1,61,ASSAM,3,2,14
15,1,GAS CYLINDER/STOVE BURST,2006,0,17,ASSAM,0,0,16
12,10,FIRE-ARMS,2006,0,12,ASSAM,0,0,2
36,28,SUDDEN DEATHS(HEART ATTACKS),2006,0,35,ASSAM,1,1,7
0,0,EPILEPTIC FITS/GIDDINESS,2006,0,0,ASSAM,0,0,0
1,0,ABORTIONS/CHILD BIRTH,2006,0,1,ASSAM,0,0,1
4,3,INFLUENCE OF ALCOHOL,2006,0,3,ASSAM,1,1,0
17,7,FOOD POISIONING/ACCIDENTAL INTAKE OF INSECTICIDES ETC.,2006,0,17,ASSAM,0,0,10
13,12,SNAKE BITE/ANIMAL BITE,2006,0,13,ASSAM,0,0,1
226,141,OTHER,2006,0,230,ASSAM,0,0,89
450,391,RAILWAY ACCIDENTS,2006,0,455,ASSAM,0,0,64
328,239,DROWNING,2006,0,331,ASSAM,6,6,92
27,22,FALLS,2006,0,28,ASSAM,0,0,6
74,21,FIRE,2006,0,77,ASSAM,0,0,56
41,31,SUDDEN DEATHS,2006,0,39,ASSAM,2,2,8
256,160,POISONING,2006,0,260,ASSAM,0,0,100
115,98,ELECTROCUTION,2006,11,136,BIHAR,24,13,38
83,17,GAS CYLINDER/STOVE BURST,2006,14,73,BIHAR,24,10,56
13,9,FIRE-ARMS,2006,0,14,BIHAR,9,9,5
97,55,SUDDEN DEATHS(HEART ATTACKS),2006,6,83,BIHAR,15,9,28
13,8,EPILEPTIC FITS/GIDDINESS,2006,0,12,BIHAR,1,1,4
3,0,ABORTIONS/CHILD BIRTH,2006,0,3,BIHAR,0,0,3
32,29,INFLUENCE OF ALCOHOL,2006,0,30,BIHAR,2,2,1
195,116,FOOD POISIONING/ACCIDENTAL INTAKE OF INSECTICIDES ETC.,2006,0,202,BIHAR,8,8,86
37,23,SNAKE BITE/ANIMAL BITE,2006,4,33,BIHAR,7,3,10
163,91,OTHER,2006,0,177,BIHAR,2,2,86
1230,951,RAILWAY ACCIDENTS,2006,0,1234,BIHAR,2,2,283
242,198,DROWNING,2006,5,286,BIHAR,36,31,88
80,73,FALLS,2006,0,84,BIHAR,16,16,11
373,125,FIRE,2006,36,361,BIHAR,95,59,236
145,92,SUDDEN DEATHS,2006,6,128,BIHAR,18,12,36
455,262,POISONING,2006,7,471,BIHAR,28,21,209
398,327,ELECTROCUTION,2006,0,399,CHHATTISGARH,0,0,72
9,2,GAS CYLINDER/STOVE BURST,2006,0,9,CHHATTISGARH,0,0,7
81,76,FIRE-ARMS,2006,0,81,CHHATTISGARH,0,0,5
168,132,SUDDEN DEATHS(HEART ATTACKS),2006,0,168,CHHATTISGARH,0,0,36
73,64,EPILEPTIC FITS/GIDDINESS,2006,0,79,CHHATTISGARH,0,0,15
28,0,ABORTIONS/CHILD BIRTH,2006,0,28,CHHATTISGARH,0,0,28
200,177,INFLUENCE OF ALCOHOL,2006,0,200,CHHATTISGARH,0,0,23
519,311,FOOD POISIONING/ACCIDENTAL INTAKE OF INSECTICIDES ETC.,2006,0,519,CHHATTISGARH,0,0,208
833,470,SNAKE BITE/ANIMAL BITE,2006,0,833,CHHATTISGARH,0,0,363
172,114,OTHER,2006,0,172,CHHATTISGARH,0,0,58
462,386,RAILWAY ACCIDENTS,2006,0,462,CHHATTISGARH,4,4,76
1350,929,DROWNING,2006,0,1350,CHHATTISGARH,0,0,421
294,242,FALLS,2006,0,294,CHHATTISGARH,0,0,52
554,180,FIRE,2006,2,574,CHHATTISGARH,2,0,394
469,373,SUDDEN DEATHS,2006,0,475,CHHATTISGARH,0,0,102
1567,924,POISONING,2006,0,1567,CHHATTISGARH,0,0,643
21,20,ELECTROCUTION,2006,0,22,GOA,0,0,2
6,2,GAS CYLINDER/STOVE BURST,2006,0,6,GOA,0,0,4
0,0,FIRE-ARMS,2006,0,0,GOA,0,0,0
5,4,SUDDEN DEATHS(HEART ATTACKS),2006,0,5,GOA,0,0,1
4,4,EPILEPTIC FITS/GIDDINESS,2006,0,4,GOA,0,0,0
0,0,ABORTIONS/CHILD BIRTH,2006,0,0,GOA,0,0,0
7,7,INFLUENCE OF ALCOHOL,2006,0,7,GOA,0,0,0
1,0,FOOD POISIONING/ACCIDENTAL INTAKE OF INSECTICIDES ETC.,2006,0,1,GOA,0,0,1
4,3,SNAKE BITE/ANIMAL BITE,2006,0,4,GOA,0,0,1
5,5,OTHER,2006,0,5,GOA,0,0,0
28,27,RAILWAY ACCIDENTS,2006,0,31,GOA,0,0,4
172,166,DROWNING,2006,0,180,GOA,0,0,14
67,76,FALLS,2006,0,86,GOA,0,0,10
29,12,FIRE,2006,0,35,GOA,0,0,23
16,15,SUDDEN DEATHS,2006,0,16,GOA,0,0,1
10,8,POISONING,2006,0,10,GOA,0,0,2
454,373,ELECTROCUTION,2006,3,446,GUJARAT,15,12,73
607,202,GAS CYLINDER/STOVE BURST,2006,10,610,GUJARAT,14,4,408
1,0,FIRE-ARMS,2006,0,1,GUJARAT,0,0,1
1325,1162,SUDDEN DEATHS(HEART ATTACKS),2006,0,1323,GUJARAT,2,2,161
425,356,EPILEPTIC FITS/GIDDINESS,2006,0,427,GUJARAT,0,0,71
27,0,ABORTIONS/CHILD BIRTH,2006,0,27,GUJARAT,0,0,27
15,13,INFLUENCE OF ALCOHOL,2006,0,15,GUJARAT,0,0,2
425,241,FOOD POISIONING/ACCIDENTAL INTAKE OF INSECTICIDES ETC.,2006,39,344,GUJARAT,81,42,103
479,261,SNAKE BITE/ANIMAL BITE,2006,28,406,GUJARAT,73,45,145
287,195,OTHER,2006,0,287,GUJARAT,0,0,92
1117,986,RAILWAY ACCIDENTS,2006,9,1124,GUJARAT,13,4,138
1738,1498,DROWNING,2006,1,1788,GUJARAT,3,2,290
1000,829,FALLS,2006,8,971,GUJARAT,35,27,142
2400,748,FIRE,2006,76,2327,GUJARAT,120,44,1579
1792,1531,SUDDEN DEATHS,2006,0,1792,GUJARAT,2,2,261
1274,758,POISONING,2006,67,1125,GUJARAT,154,87,367
238,219,ELECTROCUTION,2006,0,238,HARYANA,0,0,19
117,25,GAS CYLINDER/STOVE BURST,2006,0,117,HARYANA,0,0,92
23,19,FIRE-ARMS,2006,0,23,HARYANA,0,0,4
320,294,SUDDEN DEATHS(HEART ATTACKS),2006,0,320,HARYANA,0,0,26
44,38,EPILEPTIC FITS/GIDDINESS,2006,0,44,HARYANA,0,0,6
4,0,ABORTIONS/CHILD BIRTH,2006,0,4,HARYANA,0,0,4
139,139,INFLUENCE OF ALCOHOL,2006,0,139,HARYANA,0,0,0
213,147,FOOD POISIONING/ACCIDENTAL INTAKE OF INSECTICIDES ETC.,2006,0,213,HARYANA,0,0,66
48,42,SNAKE BITE/ANIMAL BITE,2006,0,48,HARYANA,0,0,6
510,365,OTHER,2006,0,510,HARYANA,0,0,145
1526,1406,RAILWAY ACCIDENTS,2006,0,1526,HARYANA,0,0,120
393,318,DROWNING,2006,0,393,HARYANA,0,0,75
200,175,FALLS,2006,0,200,HARYANA,0,0,25
403,160,FIRE,2006,0,403,HARYANA,0,0,243
507,471,SUDDEN DEATHS,2006,0,507,HARYANA,0,0,36
785,571,POISONING,2006,0,791,HARYANA,0,0,220
3,2,ELECTROCUTION,2006,0,3,HIMACHAL PRADESH,0,0,1
11,3,GAS CYLINDER/STOVE BURST,2006,0,11,HIMACHAL PRADESH,0,0,8
3,0,FIRE-ARMS,2006,0,0,HIMACHAL PRADESH,3,3,0
116,112,SUDDEN DEATHS(HEART ATTACKS),2006,0,116,HIMACHAL PRADESH,0,0,4
9,6,EPILEPTIC FITS/GIDDINESS,2006,0,9,HIMACHAL PRADESH,0,0,3
0,0,ABORTIONS/CHILD BIRTH,2006,0,0,HIMACHAL PRADESH,0,0,0
41,41,INFLUENCE OF ALCOHOL,2006,0,41,HIMACHAL PRADESH,0,0,0
77,40,FOOD POISIONING/ACCIDENTAL INTAKE OF INSECTICIDES ETC.,2006,0,81,HIMACHAL PRADESH,0,0,41
13,8,SNAKE BITE/ANIMAL BITE,2006,0,13,HIMACHAL PRADESH,0,0,5
37,32,OTHER,2006,0,45,HIMACHAL PRADESH,0,0,13
18,17,RAILWAY ACCIDENTS,2006,0,18,HIMACHAL PRADESH,0,0,1
97,92,DROWNING,2006,0,112,HIMACHAL PRADESH,0,0,20
230,220,FALLS,2006,0,250,HIMACHAL PRADESH,0,0,30
35,17,FIRE,2006,0,34,HIMACHAL PRADESH,1,1,17
166,159,SUDDEN DEATHS,2006,0,166,HIMACHAL PRADESH,0,0,7
128,81,POISONING,2006,0,140,HIMACHAL PRADESH,0,0,59
27,22,ELECTROCUTION,2006,0,25,JAMMU & KASHMIR,3,3,3
8,1,GAS CYLINDER/STOVE BURST,2006,3,8,JAMMU & KASHMIR,4,1,7
39,39,FIRE-ARMS,2006,1,43,JAMMU & KASHMIR,25,24,4
80,66,SUDDEN DEATHS(HEART ATTACKS),2006,2,78,JAMMU & KASHMIR,2,0,12
1,1,EPILEPTIC FITS/GIDDINESS,2006,0,1,JAMMU & KASHMIR,0,0,0
7,0,ABORTIONS/CHILD BIRTH,2006,0,6,JAMMU & KASHMIR,0,0,6
9,8,INFLUENCE OF ALCOHOL,2006,0,9,JAMMU & KASHMIR,0,0,1
22,10,FOOD POISIONING/ACCIDENTAL INTAKE OF INSECTICIDES ETC.,2006,3,18,JAMMU & KASHMIR,5,2,8
13,10,SNAKE BITE/ANIMAL BITE,2006,0,13,JAMMU & KASHMIR,0,0,3
4,2,OTHER,2006,1,3,JAMMU & KASHMIR,1,0,1
0,0,RAILWAY ACCIDENTS,2006,0,0,JAMMU & KASHMIR,0,0,0
43,30,DROWNING,2006,1,49,JAMMU & KASHMIR,1,0,19
50,37,FALLS,2006,1,46,JAMMU & KASHMIR,4,3,9
39,22,FIRE,2006,5,38,JAMMU & KASHMIR,9,4,16
97,75,SUDDEN DEATHS,2006,2,94,JAMMU & KASHMIR,2,0,19
42,23,POISONING,2006,4,38,JAMMU & KASHMIR,7,3,15
95,78,ELECTROCUTION,2006,0,95,JHARKHAND,0,0,17
81,13,GAS CYLINDER/STOVE BURST,2006,4,82,JHARKHAND,4,0,69
40,25,FIRE-ARMS,2006,0,40,JHARKHAND,0,0,15
73,59,SUDDEN DEATHS(HEART ATTACKS),2006,0,74,JHARKHAND,0,0,15
19,13,EPILEPTIC FITS/GIDDINESS,2006,0,19,JHARKHAND,0,0,6
9,0,ABORTIONS/CHILD BIRTH,2006,0,9,JHARKHAND,0,0,9
73,71,INFLUENCE OF ALCOHOL,2006,0,73,JHARKHAND,0,0,2
161,107,FOOD POISIONING/ACCIDENTAL INTAKE OF INSECTICIDES ETC.,2006,1,168,JHARKHAND,6,5,61
28,20,SNAKE BITE/ANIMAL BITE,2006,0,31,JHARKHAND,0,0,11
65,48,OTHER,2006,0,65,JHARKHAND,0,0,17
5,3,RAILWAY ACCIDENTS,2006,0,5,JHARKHAND,0,0,2
387,272,DROWNING,2006,5,378,JHARKHAND,18,13,106
148,105,FALLS,2006,3,135,JHARKHAND,12,9,30
301,95,FIRE,2006,8,298,JHARKHAND,12,4,203
174,143,SUDDEN DEATHS,2006,0,175,JHARKHAND,0,0,32
278,195,POISONING,2006,1,288,JHARKHAND,7,6,93
303,265,ELECTROCUTION,2006,2,306,KARNATAKA,4,2,41
194,42,GAS CYLINDER/STOVE BURST,2006,4,190,KARNATAKA,6,2,148
20,11,FIRE-ARMS,2006,0,21,KARNATAKA,1,1,10
449,409,SUDDEN DEATHS(HEART ATTACKS),2006,0,449,KARNATAKA,0,0,40
69,54,EPILEPTIC FITS/GIDDINESS,2006,0,71,KARNATAKA,2,2,17
6,0,ABORTIONS/CHILD BIRTH,2006,0,6,KARNATAKA,0,0,6
225,217,INFLUENCE OF ALCOHOL,2006,1,225,KARNATAKA,1,0,8
116,78,FOOD POISIONING/ACCIDENTAL INTAKE OF INSECTICIDES ETC.,2006,0,124,KARNATAKA,0,0,46
655,422,SNAKE BITE/ANIMAL BITE,2006,4,654,KARNATAKA,7,3,232
883,666,OTHER,2006,0,897,KARNATAKA,1,1,231
1168,984,RAILWAY ACCIDENTS,2006,0,1169,KARNATAKA,0,0,185
1732,1299,DROWNING,2006,7,1756,KARNATAKA,12,5,457
451,401,FALLS,2006,7,445,KARNATAKA,27,20,44
1091,325,FIRE,2006,17,1085,KARNATAKA,23,6,760
749,680,SUDDEN DEATHS,2006,1,751,KARNATAKA,3,2,71
1710,1208,POISONING,2006,4,1732,KARNATAKA,11,7,524
198,156,ELECTROCUTION,2006,0,198,KERALA,1,1,42
21,4,GAS CYLINDER/STOVE BURST,2006,0,22,KERALA,0,0,18
1,1,FIRE-ARMS,2006,0,1,KERALA,0,0,0
974,874,SUDDEN DEATHS(HEART ATTACKS),2006,0,974,KERALA,0,0,100
49,36,EPILEPTIC FITS/GIDDINESS,2006,0,49,KERALA,0,0,13
14,0,ABORTIONS/CHILD BIRTH,2006,0,13,KERALA,0,0,13
74,68,INFLUENCE OF ALCOHOL,2006,0,74,KERALA,0,0,6
15,12,FOOD POISIONING/ACCIDENTAL INTAKE OF INSECTICIDES ETC.,2006,0,16,KERALA,0,0,4
32,23,SNAKE BITE/ANIMAL BITE,2006,0,32,KERALA,0,0,9
91,71,OTHER,2006,0,95,KERALA,0,0,24
134,113,RAILWAY ACCIDENTS,2006,0,135,KERALA,0,0,22
1533,1277,DROWNING,2006,4,1588,KERALA,4,0,311
600,562,FALLS,2006,0,601,KERALA,0,0,39
243,79,FIRE,2006,1,246,KERALA,2,1,167
1111,978,SUDDEN DEATHS,2006,0,1110,KERALA,0,0,132
140,107,POISONING,2006,0,145,KERALA,0,0,38
1132,890,ELECTROCUTION,2006,1,1137,MADHYA PRADESH,8,7,247
157,28,GAS CYLINDER/STOVE BURST,2006,5,160,MADHYA PRADESH,8,3,132
128,77,FIRE-ARMS,2006,2,87,MADHYA PRADESH,32,30,10
754,598,SUDDEN DEATHS(HEART ATTACKS),2006,0,755,MADHYA PRADESH,0,0,157
111,82,EPILEPTIC FITS/GIDDINESS,2006,0,111,MADHYA PRADESH,0,0,29
193,0,ABORTIONS/CHILD BIRTH,2006,0,190,MADHYA PRADESH,0,0,190
246,240,INFLUENCE OF ALCOHOL,2006,0,246,MADHYA PRADESH,0,0,6
1995,1160,FOOD POISIONING/ACCIDENTAL INTAKE OF INSECTICIDES ETC.,2006,16,1965,MADHYA PRADESH,36,20,805
1953,1092,SNAKE BITE/ANIMAL BITE,2006,3,1953,MADHYA PRADESH,8,5,861
317,168,OTHER,2006,0,317,MADHYA PRADESH,0,0,149
1795,1544,RAILWAY ACCIDENTS,2006,0,1795,MADHYA PRADESH,0,0,251
3863,2531,DROWNING,2006,13,3849,MADHYA PRADESH,28,15,1318
745,569,FALLS,2006,3,717,MADHYA PRADESH,22,19,148
1969,628,FIRE,2006,20,2002,MADHYA PRADESH,36,16,1374
1304,920,SUDDEN DEATHS,2006,0,1302,MADHYA PRADESH,0,0,382
4393,2500,POISONING,2006,19,4364,MADHYA PRADESH,44,25,1864
1343,1022,ELECTROCUTION,2006,38,1198,MAHARASHTRA,152,114,176
415,76,GAS CYLINDER/STOVE BURST,2006,146,277,MAHARASHTRA,207,61,201
20,19,FIRE-ARMS,2006,0,19,MAHARASHTRA,2,2,0
5724,4084,SUDDEN DEATHS(HEART ATTACKS),2006,392,4784,MAHARASHTRA,940,548,700
1638,908,EPILEPTIC FITS/GIDDINESS,2006,127,1161,MAHARASHTRA,477,350,253
337,0,ABORTIONS/CHILD BIRTH,2006,2,335,MAHARASHTRA,2,0,335
1294,1116,INFLUENCE OF ALCOHOL,2006,2,1126,MAHARASHTRA,168,166,10
4598,980,FOOD POISIONING/ACCIDENTAL INTAKE OF INSECTICIDES ETC.,2006,1651,1410,MAHARASHTRA,3231,1580,430
3397,784,SNAKE BITE/ANIMAL BITE,2006,739,1246,MAHARASHTRA,2155,1416,462
24,17,OTHER,2006,0,24,MAHARASHTRA,0,0,7
8210,4414,RAILWAY ACCIDENTS,2006,384,5009,MAHARASHTRA,3301,2917,595
5481,3955,DROWNING,2006,39,5478,MAHARASHTRA,164,125,1523
2784,1636,FALLS,2006,182,1911,MAHARASHTRA,901,719,275
6194,1370,FIRE,2006,720,4985,MAHARASHTRA,1425,705,3615
8993,6108,SUDDEN DEATHS,2006,523,7406,MAHARASHTRA,1587,1064,1298
8022,1784,POISONING,2006,2390,2683,MAHARASHTRA,5386,2996,899
4,4,ELECTROCUTION,2006,0,4,MANIPUR,0,0,0
0,0,GAS CYLINDER/STOVE BURST,2006,0,0,MANIPUR,0,0,0
5,5,FIRE-ARMS,2006,0,5,MANIPUR,0,0,0
8,7,SUDDEN DEATHS(HEART ATTACKS),2006,0,8,MANIPUR,0,0,1
0,0,EPILEPTIC FITS/GIDDINESS,2006,0,0,MANIPUR,0,0,0
0,0,ABORTIONS/CHILD BIRTH,2006,0,0,MANIPUR,0,0,0
2,2,INFLUENCE OF ALCOHOL,2006,0,2,MANIPUR,1,1,0
0,0,FOOD POISIONING/ACCIDENTAL INTAKE OF INSECTICIDES ETC.,2006,0,0,MANIPUR,0,0,0
0,0,SNAKE BITE/ANIMAL BITE,2006,0,0,MANIPUR,0,0,0
3,3,OTHER,2006,0,4,MANIPUR,0,0,1
0,0,RAILWAY ACCIDENTS,2006,0,0,MANIPUR,0,0,0
6,10,DROWNING,2006,0,10,MANIPUR,0,0,0
3,3,FALLS,2006,0,3,MANIPUR,0,0,0
3,1,FIRE,2006,1,3,MANIPUR,2,1,2
10,9,SUDDEN DEATHS,2006,0,10,MANIPUR,1,1,1
3,3,POISONING,2006,0,4,MANIPUR,0,0,1
14,11,ELECTROCUTION,2006,0,14,MEGHALAYA,0,0,3
1,1,GAS CYLINDER/STOVE BURST,2006,0,1,MEGHALAYA,0,0,0
6,6,FIRE-ARMS,2006,0,6,MEGHALAYA,0,0,0
3,3,SUDDEN DEATHS(HEART ATTACKS),2006,0,3,MEGHALAYA,0,0,0
0,0,EPILEPTIC FITS/GIDDINESS,2006,0,0,MEGHALAYA,0,0,0
0,0,ABORTIONS/CHILD BIRTH,2006,0,0,MEGHALAYA,0,0,0
7,7,INFLUENCE OF ALCOHOL,2006,0,7,MEGHALAYA,0,0,0
0,0,FOOD POISIONING/ACCIDENTAL INTAKE OF INSECTICIDES ETC.,2006,0,0,MEGHALAYA,0,0,0
0,0,SNAKE BITE/ANIMAL BITE,2006,0,0,MEGHALAYA,0,0,0
1,1,OTHER,2006,0,1,MEGHALAYA,0,0,0
0,0,RAILWAY ACCIDENTS,2006,0,0,MEGHALAYA,0,0,0
27,25,DROWNING,2006,0,27,MEGHALAYA,0,0,2
14,12,FALLS,2006,0,14,MEGHALAYA,0,0,2
8,5,FIRE,2006,0,9,MEGHALAYA,0,0,4
10,10,SUDDEN DEATHS,2006,0,10,MEGHALAYA,0,0,0
1,1,POISONING,2006,0,1,MEGHALAYA,0,0,0
7,7,ELECTROCUTION,2006,0,7,MIZORAM,0,0,0
0,0,GAS CYLINDER/STOVE BURST,2006,0,0,MIZORAM,0,0,0
1,2,FIRE-ARMS,2006,0,2,MIZORAM,0,0,0
2,2,SUDDEN DEATHS(HEART ATTACKS),2006,0,2,MIZORAM,0,0,0
3,3,EPILEPTIC FITS/GIDDINESS,2006,0,3,MIZORAM,0,0,0
0,0,ABORTIONS/CHILD BIRTH,2006,0,0,MIZORAM,0,0,0
1,1,INFLUENCE OF ALCOHOL,2006,0,1,MIZORAM,0,0,0
0,0,FOOD POISIONING/ACCIDENTAL INTAKE OF INSECTICIDES ETC.,2006,0,0,MIZORAM,0,0,0
0,0,SNAKE BITE/ANIMAL BITE,2006,0,0,MIZORAM,0,0,0
0,0,OTHER,2006,0,0,MIZORAM,0,0,0
0,0,RAILWAY ACCIDENTS,2006,0,0,MIZORAM,0,0,0
13,13,DROWNING,2006,0,13,MIZORAM,0,0,0
14,12,FALLS,2006,0,14,MIZORAM,0,0,2
3,3,FIRE,2006,0,3,MIZORAM,0,0,0
6,6,SUDDEN DEATHS,2006,0,6,MIZORAM,0,0,0
1,1,POISONING,2006,0,1,MIZORAM,0,0,0
3,3,ELECTROCUTION,2006,0,3,NAGALAND,1,1,0
0,0,GAS CYLINDER/STOVE BURST,2006,0,0,NAGALAND,0,0,0
2,2,FIRE-ARMS,2006,0,2,NAGALAND,0,0,0
0,0,SUDDEN DEATHS(HEART ATTACKS),2006,0,0,NAGALAND,0,0,0
0,0,EPILEPTIC FITS/GIDDINESS,2006,0,0,NAGALAND,0,0,0
0,0,ABORTIONS/CHILD BIRTH,2006,0,0,NAGALAND,0,0,0
1,1,INFLUENCE OF ALCOHOL,2006,0,1,NAGALAND,0,0,0
0,0,FOOD POISIONING/ACCIDENTAL INTAKE OF INSECTICIDES ETC.,2006,0,0,NAGALAND,0,0,0
0,0,SNAKE BITE/ANIMAL BITE,2006,0,0,NAGALAND,0,0,0
0,0,OTHER,2006,0,0,NAGALAND,0,0,0
0,0,RAILWAY ACCIDENTS,2006,0,0,NAGALAND,0,0,0
5,4,DROWNING,2006,0,6,NAGALAND,0,0,2
1,1,FALLS,2006,0,1,NAGALAND,0,0,0
0,0,FIRE,2006,0,0,NAGALAND,0,0,0
1,1,SUDDEN DEATHS,2006,0,1,NAGALAND,0,0,0
0,0,POISONING,2006,0,0,NAGALAND,0,0,0
124,115,ELECTROCUTION,2006,0,124,ODISHA,0,0,9
24,2,GAS CYLINDER/STOVE BURST,2006,0,26,ODISHA,1,1,24
5,5,FIRE-ARMS,2006,0,5,ODISHA,0,0,0
89,72,SUDDEN DEATHS(HEART ATTACKS),2006,0,89,ODISHA,0,0,17
38,30,EPILEPTIC FITS/GIDDINESS,2006,0,38,ODISHA,0,0,8
13,0,ABORTIONS/CHILD BIRTH,2006,0,13,ODISHA,0,0,13
44,43,INFLUENCE OF ALCOHOL,2006,0,44,ODISHA,0,0,1
411,270,FOOD POISIONING/ACCIDENTAL INTAKE OF INSECTICIDES ETC.,2006,1,431,ODISHA,3,2,161
415,270,SNAKE BITE/ANIMAL BITE,2006,0,415,ODISHA,0,0,145
453,309,OTHER,2006,0,454,ODISHA,0,0,145
341,280,RAILWAY ACCIDENTS,2006,0,341,ODISHA,0,0,61
525,370,DROWNING,2006,0,540,ODISHA,0,0,170
401,332,FALLS,2006,1,406,ODISHA,2,1,74
248,118,FIRE,2006,1,252,ODISHA,4,3,134
184,145,SUDDEN DEATHS,2006,0,184,ODISHA,0,0,39
1293,862,POISONING,2006,1,1314,ODISHA,3,2,452
243,231,ELECTROCUTION,2006,0,243,PUNJAB,0,0,12
120,26,GAS CYLINDER/STOVE BURST,2006,0,120,PUNJAB,0,0,94
15,14,FIRE-ARMS,2006,0,15,PUNJAB,0,0,1
400,361,SUDDEN DEATHS(HEART ATTACKS),2006,0,400,PUNJAB,0,0,39
84,70,EPILEPTIC FITS/GIDDINESS,2006,0,84,PUNJAB,0,0,14
8,0,ABORTIONS/CHILD BIRTH,2006,0,5,PUNJAB,0,0,5
190,189,INFLUENCE OF ALCOHOL,2006,0,190,PUNJAB,0,0,1
246,188,FOOD POISIONING/ACCIDENTAL INTAKE OF INSECTICIDES ETC.,2006,0,246,PUNJAB,0,0,58
47,41,SNAKE BITE/ANIMAL BITE,2006,0,47,PUNJAB,0,0,6
243,188,OTHER,2006,0,245,PUNJAB,0,0,57
780,687,RAILWAY ACCIDENTS,2006,0,780,PUNJAB,0,0,93
430,356,DROWNING,2006,0,430,PUNJAB,0,0,74
212,194,FALLS,2006,0,212,PUNJAB,0,0,18
304,149,FIRE,2006,0,311,PUNJAB,0,0,162
682,620,SUDDEN DEATHS,2006,0,679,PUNJAB,0,0,59
725,553,POISONING,2006,0,727,PUNJAB,0,0,174
437,382,ELECTROCUTION,2006,1,446,RAJASTHAN,1,0,64
103,24,GAS CYLINDER/STOVE BURST,2006,2,104,RAJASTHAN,2,0,80
2,2,FIRE-ARMS,2006,0,2,RAJASTHAN,0,0,0
437,357,SUDDEN DEATHS(HEART ATTACKS),2006,0,437,RAJASTHAN,0,0,80
84,69,EPILEPTIC FITS/GIDDINESS,2006,0,84,RAJASTHAN,0,0,15
24,0,ABORTIONS/CHILD BIRTH,2006,0,24,RAJASTHAN,0,0,24
207,207,INFLUENCE OF ALCOHOL,2006,0,208,RAJASTHAN,0,0,1
872,583,FOOD POISIONING/ACCIDENTAL INTAKE OF INSECTICIDES ETC.,2006,0,877,RAJASTHAN,0,0,294
218,159,SNAKE BITE/ANIMAL BITE,2006,0,218,RAJASTHAN,0,0,59
245,165,OTHER,2006,0,245,RAJASTHAN,0,0,80
257,221,RAILWAY ACCIDENTS,2006,1,257,RAJASTHAN,2,1,36
1500,1113,DROWNING,2006,0,1551,RAJASTHAN,1,1,438
708,574,FALLS,2006,4,709,RAJASTHAN,11,7,135
684,269,FIRE,2006,7,692,RAJASTHAN,14,7,423
752,633,SUDDEN DEATHS,2006,0,753,RAJASTHAN,0,0,120
1343,922,POISONING,2006,0,1356,RAJASTHAN,0,0,434
5,5,ELECTROCUTION,2006,0,5,SIKKIM,0,0,0
1,0,GAS CYLINDER/STOVE BURST,2006,0,1,SIKKIM,0,0,1
1,1,FIRE-ARMS,2006,0,1,SIKKIM,0,0,0
0,0,SUDDEN DEATHS(HEART ATTACKS),2006,0,0,SIKKIM,0,0,0
0,0,EPILEPTIC FITS/GIDDINESS,2006,0,0,SIKKIM,0,0,0
0,0,ABORTIONS/CHILD BIRTH,2006,0,0,SIKKIM,0,0,0
4,3,INFLUENCE OF ALCOHOL,2006,0,4,SIKKIM,0,0,1
0,0,FOOD POISIONING/ACCIDENTAL INTAKE OF INSECTICIDES ETC.,2006,0,0,SIKKIM,0,0,0
0,0,SNAKE BITE/ANIMAL BITE,2006,0,0,SIKKIM,0,0,0
7,5,OTHER,2006,0,7,SIKKIM,0,0,2
0,0,RAILWAY ACCIDENTS,2006,0,0,SIKKIM,0,0,0
59,48,DROWNING,2006,0,59,SIKKIM,0,0,11
52,48,FALLS,2006,0,52,SIKKIM,0,0,4
1,0,FIRE,2006,0,1,SIKKIM,0,0,1
4,3,SUDDEN DEATHS,2006,0,4,SIKKIM,0,0,1
7,5,POISONING,2006,0,7,SIKKIM,0,0,2
331,318,ELECTROCUTION,2006,9,382,TAMIL NADU,57,48,64
477,71,GAS CYLINDER/STOVE BURST,2006,51,517,TAMIL NADU,60,9,446
62,38,FIRE-ARMS,2006,2,62,TAMIL NADU,2,0,24
589,561,SUDDEN DEATHS(HEART ATTACKS),2006,14,674,TAMIL NADU,43,29,113
76,62,EPILEPTIC FITS/GIDDINESS,2006,0,78,TAMIL NADU,1,1,16
7,0,ABORTIONS/CHILD BIRTH,2006,1,5,TAMIL NADU,1,0,5
76,82,INFLUENCE OF ALCOHOL,2006,3,86,TAMIL NADU,3,0,4
311,238,FOOD POISIONING/ACCIDENTAL INTAKE OF INSECTICIDES ETC.,2006,1,377,TAMIL NADU,2,1,139
483,346,SNAKE BITE/ANIMAL BITE,2006,16,530,TAMIL NADU,39,23,184
1254,784,OTHER,2006,57,1365,TAMIL NADU,190,133,581
1558,1277,RAILWAY ACCIDENTS,2006,0,1565,TAMIL NADU,0,0,288
1061,983,DROWNING,2006,18,1237,TAMIL NADU,87,69,254
425,408,FALLS,2006,3,468,TAMIL NADU,29,26,60
1502,468,FIRE,2006,136,1686,TAMIL NADU,201,65,1218
748,705,SUDDEN DEATHS,2006,18,843,TAMIL NADU,48,30,138
2181,1479,POISONING,2006,91,2416,TAMIL NADU,287,196,937
16,11,ELECTROCUTION,2006,0,16,TRIPURA,0,0,5
3,0,GAS CYLINDER/STOVE BURST,2006,0,3,TRIPURA,0,0,3
1,1,FIRE-ARMS,2006,0,1,TRIPURA,0,0,0
30,26,SUDDEN DEATHS(HEART ATTACKS),2006,0,30,TRIPURA,0,0,4
0,0,EPILEPTIC FITS/GIDDINESS,2006,0,0,TRIPURA,0,0,0
0,0,ABORTIONS/CHILD BIRTH,2006,0,0,TRIPURA,0,0,0
10,10,INFLUENCE OF ALCOHOL,2006,0,10,TRIPURA,0,0,0
0,0,FOOD POISIONING/ACCIDENTAL INTAKE OF INSECTICIDES ETC.,2006,0,0,TRIPURA,0,0,0
1,1,SNAKE BITE/ANIMAL BITE,2006,0,1,TRIPURA,0,0,0
0,0,OTHER,2006,0,0,TRIPURA,0,0,0
0,0,RAILWAY ACCIDENTS,2006,0,0,TRIPURA,0,0,0
78,53,DROWNING,2006,0,79,TRIPURA,0,0,26
6,6,FALLS,2006,0,6,TRIPURA,0,0,0
17,8,FIRE,2006,0,17,TRIPURA,0,0,9
40,36,SUDDEN DEATHS,2006,0,40,TRIPURA,0,0,4
1,1,POISONING,2006,0,1,TRIPURA,0,0,0
414,383,ELECTROCUTION,2006,13,434,UTTAR PRADESH,65,52,51
159,33,GAS CYLINDER/STOVE BURST,2006,21,143,UTTAR PRADESH,33,12,110
2328,1474,FIRE-ARMS,2006,175,1650,UTTAR PRADESH,1049,874,176
241,198,SUDDEN DEATHS(HEART ATTACKS),2006,2,240,UTTAR PRADESH,4,2,42
101,77,EPILEPTIC FITS/GIDDINESS,2006,0,100,UTTAR PRADESH,1,1,23
41,0,ABORTIONS/CHILD BIRTH,2006,1,38,UTTAR PRADESH,1,0,38
152,135,INFLUENCE OF ALCOHOL,2006,0,139,UTTAR PRADESH,27,27,4
465,270,FOOD POISIONING/ACCIDENTAL INTAKE OF INSECTICIDES ETC.,2006,10,472,UTTAR PRADESH,25,15,202
105,71,SNAKE BITE/ANIMAL BITE,2006,5,99,UTTAR PRADESH,17,12,28
156,101,OTHER,2006,10,148,UTTAR PRADESH,31,21,47
2158,2294,RAILWAY ACCIDENTS,2006,41,2790,UTTAR PRADESH,137,96,496
627,508,DROWNING,2006,8,673,UTTAR PRADESH,38,30,165
223,166,FALLS,2006,6,213,UTTAR PRADESH,20,14,47
980,354,FIRE,2006,99,964,UTTAR PRADESH,195,96,610
535,410,SUDDEN DEATHS,2006,3,517,UTTAR PRADESH,33,30,107
839,529,POISONING,2006,31,821,UTTAR PRADESH,98,67,292
53,49,ELECTROCUTION,2006,0,53,UTTARAKHAND,0,0,4
25,9,GAS CYLINDER/STOVE BURST,2006,0,25,UTTARAKHAND,0,0,16
10,10,FIRE-ARMS,2006,0,10,UTTARAKHAND,1,1,0
51,45,SUDDEN DEATHS(HEART ATTACKS),2006,0,51,UTTARAKHAND,0,0,6
6,6,EPILEPTIC FITS/GIDDINESS,2006,0,6,UTTARAKHAND,0,0,0
1,0,ABORTIONS/CHILD BIRTH,2006,0,1,UTTARAKHAND,0,0,1
21,21,INFLUENCE OF ALCOHOL,2006,0,21,UTTARAKHAND,2,2,0
95,63,FOOD POISIONING/ACCIDENTAL INTAKE OF INSECTICIDES ETC.,2006,0,103,UTTARAKHAND,0,0,40
6,3,SNAKE BITE/ANIMAL BITE,2006,0,6,UTTARAKHAND,0,0,3
9,4,OTHER,2006,0,9,UTTARAKHAND,0,0,5
78,64,RAILWAY ACCIDENTS,2006,0,78,UTTARAKHAND,0,0,14
74,84,DROWNING,2006,0,99,UTTARAKHAND,0,0,15
90,79,FALLS,2006,1,91,UTTARAKHAND,1,0,12
76,23,FIRE,2006,1,75,UTTARAKHAND,3,2,52
79,72,SUDDEN DEATHS,2006,0,79,UTTARAKHAND,2,2,7
110,70,POISONING,2006,0,118,UTTARAKHAND,0,0,48
89,75,ELECTROCUTION,2006,5,91,WEST BENGAL,18,13,16
81,3,GAS CYLINDER/STOVE BURST,2006,19,50,WEST BENGAL,32,13,47
32,29,FIRE-ARMS,2006,2,31,WEST BENGAL,13,11,2
719,411,SUDDEN DEATHS(HEART ATTACKS),2006,60,534,WEST BENGAL,185,125,123
10,7,EPILEPTIC FITS/GIDDINESS,2006,0,10,WEST BENGAL,0,0,3
18,0,ABORTIONS/CHILD BIRTH,2006,0,18,WEST BENGAL,0,0,18
104,36,INFLUENCE OF ALCOHOL,2006,1,36,WEST BENGAL,107,106,0
274,134,FOOD POISIONING/ACCIDENTAL INTAKE OF INSECTICIDES ETC.,2006,348,227,WEST BENGAL,554,206,93
439,260,SNAKE BITE/ANIMAL BITE,2006,11,430,WEST BENGAL,29,18,170
537,296,OTHER,2006,54,520,WEST BENGAL,127,73,224
1962,1591,RAILWAY ACCIDENTS,2006,0,1982,WEST BENGAL,0,0,391
410,346,DROWNING,2006,9,447,WEST BENGAL,27,18,101
132,108,FALLS,2006,11,141,WEST BENGAL,30,19,33
648,156,FIRE,2006,216,533,WEST BENGAL,451,235,377
851,454,SUDDEN DEATHS,2006,61,598,WEST BENGAL,292,231,144
1256,693,POISONING,2006,415,1181,WEST BENGAL,719,304,488
4,3,ELECTROCUTION,2006,0,4,A & N ISLANDS,0,0,1
21,3,GAS CYLINDER/STOVE BURST,2006,0,21,A & N ISLANDS,0,0,18
0,0,FIRE-ARMS,2006,0,0,A & N ISLANDS,0,0,0
38,35,SUDDEN DEATHS(HEART ATTACKS),2006,0,38,A & N ISLANDS,0,0,3
0,0,EPILEPTIC FITS/GIDDINESS,2006,0,0,A & N ISLANDS,0,0,0
0,0,ABORTIONS/CHILD BIRTH,2006,0,0,A & N ISLANDS,0,0,0
0,0,INFLUENCE OF ALCOHOL,2006,0,0,A & N ISLANDS,0,0,0
0,0,FOOD POISIONING/ACCIDENTAL INTAKE OF INSECTICIDES ETC.,2006,0,0,A & N ISLANDS,0,0,0
1,1,SNAKE BITE/ANIMAL BITE,2006,0,1,A & N ISLANDS,0,0,0
2,1,OTHER,2006,0,2,A & N ISLANDS,0,0,1
0,0,RAILWAY ACCIDENTS,2006,0,0,A & N ISLANDS,0,0,0
41,33,DROWNING,2006,0,42,A & N ISLANDS,0,0,9
6,5,FALLS,2006,0,6,A & N ISLANDS,0,0,1
21,3,FIRE,2006,0,21,A & N ISLANDS,0,0,18
38,35,SUDDEN DEATHS,2006,0,38,A & N ISLANDS,0,0,3
3,2,POISONING,2006,0,3,A & N ISLANDS,0,0,1
3,2,ELECTROCUTION,2006,0,3,CHANDIGARH,0,0,1
11,0,GAS CYLINDER/STOVE BURST,2006,0,11,CHANDIGARH,0,0,11
0,0,FIRE-ARMS,2006,0,0,CHANDIGARH,0,0,0
29,25,SUDDEN DEATHS(HEART ATTACKS),2006,0,29,CHANDIGARH,0,0,4
1,1,EPILEPTIC FITS/GIDDINESS,2006,0,1,CHANDIGARH,0,0,0
0,0,ABORTIONS/CHILD BIRTH,2006,0,0,CHANDIGARH,0,0,0
10,10,INFLUENCE OF ALCOHOL,2006,0,10,CHANDIGARH,0,0,0
0,0,FOOD POISIONING/ACCIDENTAL INTAKE OF INSECTICIDES ETC.,2006,0,0,CHANDIGARH,0,0,0
0,0,SNAKE BITE/ANIMAL BITE,2006,0,0,CHANDIGARH,0,0,0
4,2,OTHER,2006,0,4,CHANDIGARH,0,0,2
0,0,RAILWAY ACCIDENTS,2006,0,0,CHANDIGARH,0,0,0
1,1,DROWNING,2006,0,1,CHANDIGARH,0,0,0
22,17,FALLS,2006,0,22,CHANDIGARH,0,0,5
17,3,FIRE,2006,0,17,CHANDIGARH,0,0,14
40,36,SUDDEN DEATHS,2006,0,40,CHANDIGARH,0,0,4
4,2,POISONING,2006,0,4,CHANDIGARH,0,0,2
10,8,ELECTROCUTION,2006,0,10,D & N HAVELI,0,0,2
12,6,GAS CYLINDER/STOVE BURST,2006,0,12,D & N HAVELI,0,0,6
0,0,FIRE-ARMS,2006,0,0,D & N HAVELI,0,0,0
15,11,SUDDEN DEATHS(HEART ATTACKS),2006,0,15,D & N HAVELI,0,0,4
7,5,EPILEPTIC FITS/GIDDINESS,2006,0,7,D & N HAVELI,0,0,2
0,0,ABORTIONS/CHILD BIRTH,2006,0,0,D & N HAVELI,0,0,0
5,4,INFLUENCE OF ALCOHOL,2006,0,5,D & N HAVELI,0,0,1
0,0,FOOD POISIONING/ACCIDENTAL INTAKE OF INSECTICIDES ETC.,2006,0,0,D & N HAVELI,0,0,0
8,3,SNAKE BITE/ANIMAL BITE,2006,0,8,D & N HAVELI,0,0,5
0,0,OTHER,2006,0,0,D & N HAVELI,0,0,0
0,0,RAILWAY ACCIDENTS,2006,0,0,D & N HAVELI,0,0,0
23,24,DROWNING,2006,0,27,D & N HAVELI,0,0,3
20,16,FALLS,2006,0,20,D & N HAVELI,0,0,4
12,6,FIRE,2006,0,12,D & N HAVELI,0,0,6
27,20,SUDDEN DEATHS,2006,0,27,D & N HAVELI,0,0,7
8,3,POISONING,2006,0,8,D & N HAVELI,0,0,5
5,4,ELECTROCUTION,2006,0,5,DAMAN & DIU,0,0,1
0,0,GAS CYLINDER/STOVE BURST,2006,0,0,DAMAN & DIU,0,0,0
0,0,FIRE-ARMS,2006,0,0,DAMAN & DIU,0,0,0
10,9,SUDDEN DEATHS(HEART ATTACKS),2006,0,10,DAMAN & DIU,0,0,1
1,1,EPILEPTIC FITS/GIDDINESS,2006,0,1,DAMAN & DIU,0,0,0
0,0,ABORTIONS/CHILD BIRTH,2006,0,0,DAMAN & DIU,0,0,0
5,5,INFLUENCE OF ALCOHOL,2006,0,5,DAMAN & DIU,0,0,0
0,0,FOOD POISIONING/ACCIDENTAL INTAKE OF INSECTICIDES ETC.,2006,0,0,DAMAN & DIU,0,0,0
0,0,SNAKE BITE/ANIMAL BITE,2006,0,0,DAMAN & DIU,0,0,0
0,0,OTHER,2006,0,0,DAMAN & DIU,0,0,0
0,0,RAILWAY ACCIDENTS,2006,0,0,DAMAN & DIU,0,0,0
21,21,DROWNING,2006,0,23,DAMAN & DIU,0,0,2
11,10,FALLS,2006,0,11,DAMAN & DIU,0,0,1
5,0,FIRE,2006,0,5,DAMAN & DIU,0,0,5
16,15,SUDDEN DEATHS,2006,0,16,DAMAN & DIU,0,0,1
2,1,POISONING,2006,0,2,DAMAN & DIU,0,0,1
134,114,ELECTROCUTION,2006,1,132,DELHI(UT),6,5,18
101,33,GAS CYLINDER/STOVE BURST,2006,5,113,DELHI(UT),18,13,80
24,15,FIRE-ARMS,2006,1,18,DELHI(UT),12,11,3
181,162,SUDDEN DEATHS(HEART ATTACKS),2006,0,181,DELHI(UT),0,0,19
15,14,EPILEPTIC FITS/GIDDINESS,2006,0,15,DELHI(UT),0,0,1
29,0,ABORTIONS/CHILD BIRTH,2006,0,29,DELHI(UT),0,0,29
84,82,INFLUENCE OF ALCOHOL,2006,0,83,DELHI(UT),1,1,1
99,75,FOOD POISIONING/ACCIDENTAL INTAKE OF INSECTICIDES ETC.,2006,0,103,DELHI(UT),1,1,28
7,6,SNAKE BITE/ANIMAL BITE,2006,0,7,DELHI(UT),0,0,1
119,80,OTHER,2006,0,121,DELHI(UT),0,0,41
924,744,RAILWAY ACCIDENTS,2006,11,853,DELHI(UT),72,61,109
175,155,DROWNING,2006,0,182,DELHI(UT),0,0,27
342,276,FALLS,2006,2,345,DELHI(UT),20,18,69
439,217,FIRE,2006,13,467,DELHI(UT),45,32,250
309,258,SUDDEN DEATHS,2006,0,308,DELHI(UT),1,1,50
226,162,POISONING,2006,0,232,DELHI(UT),1,1,70
1,1,ELECTROCUTION,2006,0,1,LAKSHADWEEP,0,0,0
0,0,GAS CYLINDER/STOVE BURST,2006,0,0,LAKSHADWEEP,0,0,0
0,0,FIRE-ARMS,2006,0,0,LAKSHADWEEP,0,0,0
0,0,SUDDEN DEATHS(HEART ATTACKS),2006,0,0,LAKSHADWEEP,0,0,0
0,0,EPILEPTIC FITS/GIDDINESS,2006,0,0,LAKSHADWEEP,0,0,0
0,0,ABORTIONS/CHILD BIRTH,2006,0,0,LAKSHADWEEP,0,0,0
0,0,INFLUENCE OF ALCOHOL,2006,0,0,LAKSHADWEEP,0,0,0
0,0,FOOD POISIONING/ACCIDENTAL INTAKE OF INSECTICIDES ETC.,2006,0,0,LAKSHADWEEP,0,0,0
0,0,SNAKE BITE/ANIMAL BITE,2006,0,0,LAKSHADWEEP,0,0,0
0,0,OTHER,2006,0,0,LAKSHADWEEP,0,0,0
0,0,RAILWAY ACCIDENTS,2006,0,0,LAKSHADWEEP,0,0,0
4,2,DROWNING,2006,0,4,LAKSHADWEEP,0,0,2
0,0,FALLS,2006,0,0,LAKSHADWEEP,0,0,0
0,0,FIRE,2006,0,0,LAKSHADWEEP,0,0,0
0,0,SUDDEN DEATHS,2006,0,0,LAKSHADWEEP,0,0,0
0,0,POISONING,2006,0,0,LAKSHADWEEP,0,0,0
24,17,ELECTROCUTION,2006,0,24,PUDUCHERRY,0,0,7
0,0,GAS CYLINDER/STOVE BURST,2006,0,0,PUDUCHERRY,0,0,0
0,0,FIRE-ARMS,2006,0,0,PUDUCHERRY,0,0,0
71,66,SUDDEN DEATHS(HEART ATTACKS),2006,0,71,PUDUCHERRY,0,0,5
66,61,EPILEPTIC FITS/GIDDINESS,2006,0,66,PUDUCHERRY,0,0,5
1,0,ABORTIONS/CHILD BIRTH,2006,0,1,PUDUCHERRY,0,0,1
188,183,INFLUENCE OF ALCOHOL,2006,0,188,PUDUCHERRY,0,0,5
3,2,FOOD POISIONING/ACCIDENTAL INTAKE OF INSECTICIDES ETC.,2006,0,3,PUDUCHERRY,0,0,1
15,7,SNAKE BITE/ANIMAL BITE,2006,0,15,PUDUCHERRY,0,0,8
1,1,OTHER,2006,0,1,PUDUCHERRY,0,0,0
6,7,RAILWAY ACCIDENTS,2006,0,7,PUDUCHERRY,0,0,0
100,85,DROWNING,2006,0,100,PUDUCHERRY,0,0,15
38,33,FALLS,2006,0,38,PUDUCHERRY,0,0,5
50,15,FIRE,2006,3,50,PUDUCHERRY,5,2,35
326,310,SUDDEN DEATHS,2006,0,326,PUDUCHERRY,0,0,16
19,10,POISONING,2006,0,19,PUDUCHERRY,0,0,9
