CAUSE,FEMALE KILLED,FEMALE INJURED,CASES,STATE/UT,TOTAL INJURED,MALE KILLED,MALE INJURED,YEAR,TOTAL KILLED
ELECTROCUTION,199,6,1339,ANDHRA PRADESH,11,1149,5,2009,1348
GAS CYLINDER/STOVE BURST,424,16,514,ANDHRA PRADESH,16,104,0,2009,528
FIRE-ARMS,1,0,11,ANDHRA PRADESH,0,10,0,2009,11
SUDDEN DEATHS(HEART ATTACKS),84,0,490,ANDHRA PRADESH,0,406,0,2009,490
EPILEPTIC FITS/GIDDINESS,16,0,91,ANDHRA PRADESH,1,73,1,2009,89
ABORTIONS/CHILD BIRTH,4,0,4,ANDHRA PRADESH,0,0,0,2009,4
INFLUENCE OF ALCOHOL,26,0,251,ANDHRA PRADESH,0,235,0,2009,261
FOOD POISIONING/ACCIDENTAL INTAKE OF INSECTICIDES ETC.,96,0,296,ANDHRA PRADESH,0,204,0,2009,300
SNAKE BITE/ANIMAL BITE,250,2,803,ANDHRA PRADESH,7,554,5,2009,804
OTHER,257,3,890,ANDHRA PRADESH,6,670,3,2009,927
RAILWAY ACCIDENTS,174,1,1402,ANDHRA PRADESH,3,1230,2,2009,1404
DROWNING,508,4,2194,ANDHRA PRADESH,23,1769,19,2009,2277
FALLS,170,4,1289,ANDHRA PRADESH,31,1103,27,2009,1273
FIRE,1080,37,1649,ANDHRA PRADESH,66,590,29,2009,1670
SUDDEN DEATHS,130,0,836,ANDHRA PRADESH,1,714,1,2009,844
POISONING,624,5,2074,ANDHRA PRADESH,14,1491,9,2009,2115
ELECTROCUTION,0,0,3,ARUNACHAL PRADESH,0,3,0,2009,3
GAS CYLINDER/STOVE BURST,0,0,1,ARUNACHAL PRADESH,0,1,0,2009,1
FIRE-ARMS,0,0,3,ARUNACHAL PRADESH,0,4,0,2009,4
SUDDEN DEATHS(HEART ATTACKS),2,0,12,ARUNACHAL PRADESH,0,10,0,2009,12
EPILEPTIC FITS/GIDDINESS,0,0,0,ARUNACHAL PRADESH,0,0,0,2009,0
ABORTIONS/CHILD BIRTH,0,0,0,ARUNACHAL PRADESH,0,0,0,2009,0
INFLUENCE OF ALCOHOL,0,0,5,ARUNACHAL PRADESH,0,5,0,2009,5
FOOD POISIONING/ACCIDENTAL INTAKE OF INSECTICIDES ETC.,0,0,0,ARUNACHAL PRADESH,0,0,0,2009,0
SNAKE BITE/ANIMAL BITE,0,0,1,ARUNACHAL PRADESH,0,1,0,2009,1
OTHER,4,0,10,ARUNACHAL PRADESH,0,22,0,2009,26
RAILWAY ACCIDENTS,0,0,0,ARUNACHAL PRADESH,0,0,0,2009,0
DROWNING,3,0,16,ARUNACHAL PRADESH,0,15,0,2009,18
FALLS,1,0,21,ARUNACHAL PRADESH,1,20,1,2009,21
FIRE,0,0,7,ARUNACHAL PRADESH,0,8,0,2009,8
SUDDEN DEATHS,2,0,17,ARUNACHAL PRADESH,0,15,0,2009,17
POISONING,4,0,11,ARUNACHAL PRADESH,0,23,0,2009,27
ELECTROCUTION,4,0,50,ASSAM,0,47,0,2009,51
GAS CYLINDER/STOVE BURST,7,0,9,ASSAM,0,2,0,2009,9
FIRE-ARMS,4,1,16,ASSAM,4,16,3,2009,20
SUDDEN DEATHS(HEART ATTACKS),3,0,19,ASSAM,0,16,0,2009,19
EPILEPTIC FITS/GIDDINESS,0,0,0,ASSAM,0,0,0,2009,0
ABORTIONS/CHILD BIRTH,8,0,8,ASSAM,0,0,0,2009,8
INFLUENCE OF ALCOHOL,0,0,3,ASSAM,0,8,0,2009,8
FOOD POISIONING/ACCIDENTAL INTAKE OF INSECTICIDES ETC.,5,4,15,ASSAM,12,10,8,2009,15
SNAKE BITE/ANIMAL BITE,2,0,4,ASSAM,0,2,0,2009,4
OTHER,58,0,111,ASSAM,1,77,1,2009,135
RAILWAY ACCIDENTS,48,0,425,ASSAM,0,377,0,2009,425
DROWNING,62,0,278,ASSAM,0,243,0,2009,305
FALLS,2,0,28,ASSAM,0,26,0,2009,28
FIRE,74,0,106,ASSAM,0,32,0,2009,106
SUDDEN DEATHS,11,0,30,ASSAM,0,24,0,2009,35
POISONING,68,4,137,ASSAM,13,118,9,2009,186
ELECTROCUTION,18,2,131,BIHAR,16,111,14,2009,129
GAS CYLINDER/STOVE BURST,111,14,149,BIHAR,18,40,4,2009,151
FIRE-ARMS,7,2,14,BIHAR,4,6,2,2009,13
SUDDEN DEATHS(HEART ATTACKS),33,6,135,BIHAR,17,88,11,2009,121
EPILEPTIC FITS/GIDDINESS,5,2,33,BIHAR,7,23,5,2009,28
ABORTIONS/CHILD BIRTH,7,0,7,BIHAR,0,0,0,2009,7
INFLUENCE OF ALCOHOL,5,0,78,BIHAR,6,75,6,2009,80
FOOD POISIONING/ACCIDENTAL INTAKE OF INSECTICIDES ETC.,185,27,378,BIHAR,45,218,18,2009,403
SNAKE BITE/ANIMAL BITE,11,0,30,BIHAR,0,18,0,2009,29
OTHER,58,6,170,BIHAR,20,112,14,2009,170
RAILWAY ACCIDENTS,207,0,1134,BIHAR,0,927,0,2009,1134
DROWNING,128,6,280,BIHAR,25,240,19,2009,368
FALLS,22,2,105,BIHAR,12,86,10,2009,108
FIRE,384,45,540,BIHAR,97,178,52,2009,562
SUDDEN DEATHS,50,8,253,BIHAR,30,186,22,2009,236
POISONING,263,34,623,BIHAR,72,384,38,2009,647
ELECTROCUTION,81,4,449,CHHATTISGARH,11,368,7,2009,449
GAS CYLINDER/STOVE BURST,41,0,46,CHHATTISGARH,0,5,0,2009,46
FIRE-ARMS,2,0,84,CHHATTISGARH,1,82,1,2009,84
SUDDEN DEATHS(HEART ATTACKS),44,0,283,CHHATTISGARH,2,239,2,2009,283
EPILEPTIC FITS/GIDDINESS,15,3,69,CHHATTISGARH,11,61,8,2009,76
ABORTIONS/CHILD BIRTH,41,0,41,CHHATTISGARH,0,0,0,2009,41
INFLUENCE OF ALCOHOL,34,6,259,CHHATTISGARH,33,226,27,2009,260
FOOD POISIONING/ACCIDENTAL INTAKE OF INSECTICIDES ETC.,222,0,571,CHHATTISGARH,0,352,0,2009,574
SNAKE BITE/ANIMAL BITE,315,1,759,CHHATTISGARH,7,437,6,2009,752
OTHER,99,7,357,CHHATTISGARH,10,255,3,2009,354
RAILWAY ACCIDENTS,86,5,459,CHHATTISGARH,14,371,9,2009,457
DROWNING,409,24,1368,CHHATTISGARH,51,960,27,2009,1369
FALLS,74,5,425,CHHATTISGARH,12,343,7,2009,417
FIRE,603,33,837,CHHATTISGARH,45,234,12,2009,837
SUDDEN DEATHS,134,9,652,CHHATTISGARH,46,526,37,2009,660
POISONING,638,8,1700,CHHATTISGARH,17,1055,9,2009,1693
ELECTROCUTION,4,0,24,GOA,0,21,0,2009,25
GAS CYLINDER/STOVE BURST,6,0,6,GOA,0,0,0,2009,6
FIRE-ARMS,0,0,0,GOA,0,0,0,2009,0
SUDDEN DEATHS(HEART ATTACKS),0,0,8,GOA,0,8,0,2009,8
EPILEPTIC FITS/GIDDINESS,0,0,0,GOA,0,0,0,2009,0
ABORTIONS/CHILD BIRTH,1,0,1,GOA,0,0,0,2009,1
INFLUENCE OF ALCOHOL,0,0,7,GOA,0,7,0,2009,7
FOOD POISIONING/ACCIDENTAL INTAKE OF INSECTICIDES ETC.,0,0,0,GOA,0,0,0,2009,0
SNAKE BITE/ANIMAL BITE,3,0,5,GOA,0,2,0,2009,5
OTHER,1,0,2,GOA,0,1,0,2009,2
RAILWAY ACCIDENTS,4,0,40,GOA,0,36,0,2009,40
DROWNING,19,0,177,GOA,0,162,0,2009,181
FALLS,5,0,103,GOA,0,98,0,2009,103
FIRE,38,0,49,GOA,0,11,0,2009,49
SUDDEN DEATHS,1,0,16,GOA,0,15,0,2009,16
POISONING,4,0,7,GOA,0,3,0,2009,7
ELECTROCUTION,85,5,505,GUJARAT,14,413,9,2009,498
GAS CYLINDER/STOVE BURST,639,8,868,GUJARAT,19,219,11,2009,858
FIRE-ARMS,1,0,1,GUJARAT,0,0,0,2009,1
SUDDEN DEATHS(HEART ATTACKS),210,0,2004,GUJARAT,0,1795,0,2009,2005
EPILEPTIC FITS/GIDDINESS,91,0,512,GUJARAT,0,422,0,2009,513
ABORTIONS/CHILD BIRTH,33,1,33,GUJARAT,1,0,0,2009,33
INFLUENCE OF ALCOHOL,4,0,148,GUJARAT,0,170,0,2009,174
FOOD POISIONING/ACCIDENTAL INTAKE OF INSECTICIDES ETC.,161,21,497,GUJARAT,47,298,26,2009,459
SNAKE BITE/ANIMAL BITE,232,82,756,GUJARAT,189,346,107,2009,578
OTHER,130,36,391,GUJARAT,54,208,18,2009,338
RAILWAY ACCIDENTS,138,0,1026,GUJARAT,0,885,0,2009,1023
DROWNING,331,5,1634,GUJARAT,22,1327,17,2009,1658
FALLS,192,17,1115,GUJARAT,63,883,46,2009,1075
FIRE,1608,58,2551,GUJARAT,110,859,52,2009,2467
SUDDEN DEATHS,338,1,2697,GUJARAT,1,2387,0,2009,2725
POISONING,553,139,1776,GUJARAT,290,954,151,2009,1507
ELECTROCUTION,14,0,343,HARYANA,0,329,0,2009,343
GAS CYLINDER/STOVE BURST,104,0,142,HARYANA,0,38,0,2009,142
FIRE-ARMS,4,0,31,HARYANA,0,27,0,2009,31
SUDDEN DEATHS(HEART ATTACKS),48,0,458,HARYANA,0,410,0,2009,458
EPILEPTIC FITS/GIDDINESS,9,0,53,HARYANA,0,44,0,2009,53
ABORTIONS/CHILD BIRTH,11,0,11,HARYANA,0,0,0,2009,11
INFLUENCE OF ALCOHOL,0,0,246,HARYANA,0,246,0,2009,246
FOOD POISIONING/ACCIDENTAL INTAKE OF INSECTICIDES ETC.,96,0,324,HARYANA,0,228,0,2009,324
SNAKE BITE/ANIMAL BITE,7,0,72,HARYANA,0,65,0,2009,72
OTHER,45,0,188,HARYANA,0,143,0,2009,188
RAILWAY ACCIDENTS,115,0,1131,HARYANA,0,1016,0,2009,1131
DROWNING,77,0,605,HARYANA,0,529,0,2009,606
FALLS,30,0,247,HARYANA,0,217,0,2009,247
FIRE,247,0,423,HARYANA,0,176,0,2009,423
SUDDEN DEATHS,68,0,768,HARYANA,0,700,0,2009,768
POISONING,148,0,596,HARYANA,0,448,0,2009,596
ELECTROCUTION,0,0,19,HIMACHAL PRADESH,0,19,0,2009,19
GAS CYLINDER/STOVE BURST,7,0,10,HIMACHAL PRADESH,0,3,0,2009,10
FIRE-ARMS,0,0,2,HIMACHAL PRADESH,2,0,2,2009,0
SUDDEN DEATHS(HEART ATTACKS),9,0,135,HIMACHAL PRADESH,0,126,0,2009,135
EPILEPTIC FITS/GIDDINESS,0,0,2,HIMACHAL PRADESH,0,2,0,2009,2
ABORTIONS/CHILD BIRTH,2,0,2,HIMACHAL PRADESH,0,0,0,2009,2
INFLUENCE OF ALCOHOL,0,0,66,HIMACHAL PRADESH,0,66,0,2009,66
FOOD POISIONING/ACCIDENTAL INTAKE OF INSECTICIDES ETC.,28,0,55,HIMACHAL PRADESH,0,27,0,2009,55
SNAKE BITE/ANIMAL BITE,9,1,20,HIMACHAL PRADESH,1,10,0,2009,19
OTHER,49,0,121,HIMACHAL PRADESH,0,87,0,2009,136
RAILWAY ACCIDENTS,4,0,15,HIMACHAL PRADESH,0,11,0,2009,15
DROWNING,35,0,121,HIMACHAL PRADESH,1,85,1,2009,120
FALLS,37,2,329,HIMACHAL PRADESH,2,290,0,2009,327
FIRE,43,0,87,HIMACHAL PRADESH,0,52,0,2009,95
SUDDEN DEATHS,11,0,205,HIMACHAL PRADESH,0,194,0,2009,205
POISONING,86,1,197,HIMACHAL PRADESH,1,125,0,2009,211
ELECTROCUTION,0,0,9,JAMMU & KASHMIR,3,8,3,2009,8
GAS CYLINDER/STOVE BURST,5,2,8,JAMMU & KASHMIR,2,1,0,2009,6
FIRE-ARMS,4,4,45,JAMMU & KASHMIR,23,31,19,2009,35
SUDDEN DEATHS(HEART ATTACKS),6,0,45,JAMMU & KASHMIR,0,41,0,2009,47
EPILEPTIC FITS/GIDDINESS,0,0,1,JAMMU & KASHMIR,0,1,0,2009,1
ABORTIONS/CHILD BIRTH,0,0,0,JAMMU & KASHMIR,0,0,0,2009,0
INFLUENCE OF ALCOHOL,0,0,16,JAMMU & KASHMIR,0,16,0,2009,16
FOOD POISIONING/ACCIDENTAL INTAKE OF INSECTICIDES ETC.,7,0,15,JAMMU & KASHMIR,0,8,0,2009,15
SNAKE BITE/ANIMAL BITE,0,0,0,JAMMU & KASHMIR,0,0,0,2009,0
OTHER,27,0,53,JAMMU & KASHMIR,0,26,0,2009,53
RAILWAY ACCIDENTS,0,0,0,JAMMU & KASHMIR,0,0,0,2009,0
DROWNING,20,2,61,JAMMU & KASHMIR,2,51,0,2009,71
FALLS,12,1,58,JAMMU & KASHMIR,6,43,5,2009,55
FIRE,13,2,42,JAMMU & KASHMIR,4,27,2,2009,40
SUDDEN DEATHS,6,0,62,JAMMU & KASHMIR,0,58,0,2009,64
POISONING,39,0,80,JAMMU & KASHMIR,0,40,0,2009,79
ELECTROCUTION,18,1,75,JHARKHAND,6,101,5,2009,119
GAS CYLINDER/STOVE BURST,38,5,47,JHARKHAND,6,12,1,2009,50
FIRE-ARMS,11,0,12,JHARKHAND,0,3,0,2009,14
SUDDEN DEATHS(HEART ATTACKS),16,1,70,JHARKHAND,4,64,3,2009,80
EPILEPTIC FITS/GIDDINESS,4,0,29,JHARKHAND,1,27,1,2009,31
ABORTIONS/CHILD BIRTH,20,6,27,JHARKHAND,6,0,0,2009,20
INFLUENCE OF ALCOHOL,6,1,78,JHARKHAND,3,77,2,2009,83
FOOD POISIONING/ACCIDENTAL INTAKE OF INSECTICIDES ETC.,72,3,196,JHARKHAND,18,114,15,2009,186
SNAKE BITE/ANIMAL BITE,10,0,38,JHARKHAND,1,28,1,2009,38
OTHER,26,0,125,JHARKHAND,5,99,5,2009,125
RAILWAY ACCIDENTS,70,14,543,JHARKHAND,63,418,49,2009,488
DROWNING,81,12,316,JHARKHAND,45,244,33,2009,325
FALLS,33,4,135,JHARKHAND,14,104,10,2009,137
FIRE,156,25,392,JHARKHAND,72,168,47,2009,324
SUDDEN DEATHS,46,8,204,JHARKHAND,14,168,6,2009,214
POISONING,115,3,407,JHARKHAND,26,283,23,2009,398
ELECTROCUTION,53,2,372,KARNATAKA,11,312,9,2009,365
GAS CYLINDER/STOVE BURST,224,13,374,KARNATAKA,34,117,21,2009,341
FIRE-ARMS,10,0,18,KARNATAKA,0,8,0,2009,18
SUDDEN DEATHS(HEART ATTACKS),52,0,613,KARNATAKA,5,557,5,2009,609
EPILEPTIC FITS/GIDDINESS,24,0,182,KARNATAKA,0,159,0,2009,183
ABORTIONS/CHILD BIRTH,15,0,15,KARNATAKA,0,0,0,2009,15
INFLUENCE OF ALCOHOL,9,0,264,KARNATAKA,6,249,6,2009,258
FOOD POISIONING/ACCIDENTAL INTAKE OF INSECTICIDES ETC.,77,1,175,KARNATAKA,5,104,4,2009,181
SNAKE BITE/ANIMAL BITE,275,1,720,KARNATAKA,1,447,0,2009,722
OTHER,373,4,1282,KARNATAKA,17,1022,13,2009,1395
RAILWAY ACCIDENTS,228,0,1441,KARNATAKA,0,1221,0,2009,1449
DROWNING,548,3,1926,KARNATAKA,6,1466,3,2009,2014
FALLS,38,5,478,KARNATAKA,14,432,9,2009,470
FIRE,1042,28,1667,KARNATAKA,55,583,27,2009,1625
SUDDEN DEATHS,100,0,1074,KARNATAKA,11,965,11,2009,1065
POISONING,790,6,2372,KARNATAKA,25,1701,19,2009,2491
ELECTROCUTION,41,1,212,KERALA,3,173,2,2009,214
GAS CYLINDER/STOVE BURST,18,0,21,KERALA,0,3,0,2009,21
FIRE-ARMS,0,0,0,KERALA,0,0,0,2009,0
SUDDEN DEATHS(HEART ATTACKS),230,0,1445,KERALA,0,1215,0,2009,1445
EPILEPTIC FITS/GIDDINESS,18,0,104,KERALA,0,86,0,2009,104
ABORTIONS/CHILD BIRTH,8,0,7,KERALA,0,0,0,2009,8
INFLUENCE OF ALCOHOL,5,0,93,KERALA,0,88,0,2009,93
FOOD POISIONING/ACCIDENTAL INTAKE OF INSECTICIDES ETC.,5,17,21,KERALA,50,15,33,2009,20
SNAKE BITE/ANIMAL BITE,17,0,53,KERALA,0,36,0,2009,53
OTHER,9,0,47,KERALA,0,38,0,2009,47
RAILWAY ACCIDENTS,76,1,444,KERALA,1,372,0,2009,448
DROWNING,307,6,1617,KERALA,10,1426,4,2009,1733
FALLS,87,0,711,KERALA,0,624,0,2009,711
FIRE,213,4,320,KERALA,23,120,19,2009,333
SUDDEN DEATHS,261,0,1649,KERALA,0,1389,0,2009,1650
POISONING,31,17,121,KERALA,50,89,33,2009,120
ELECTROCUTION,215,2,1140,MADHYA PRADESH,21,934,19,2009,1149
GAS CYLINDER/STOVE BURST,111,14,152,MADHYA PRADESH,18,45,4,2009,156
FIRE-ARMS,19,4,135,MADHYA PRADESH,26,115,22,2009,134
SUDDEN DEATHS(HEART ATTACKS),109,1,808,MADHYA PRADESH,8,723,7,2009,832
EPILEPTIC FITS/GIDDINESS,37,0,155,MADHYA PRADESH,2,119,2,2009,156
ABORTIONS/CHILD BIRTH,176,0,177,MADHYA PRADESH,0,0,0,2009,176
INFLUENCE OF ALCOHOL,8,0,410,MADHYA PRADESH,4,403,4,2009,411
FOOD POISIONING/ACCIDENTAL INTAKE OF INSECTICIDES ETC.,835,14,2056,MADHYA PRADESH,34,1245,20,2009,2080
SNAKE BITE/ANIMAL BITE,836,6,2048,MADHYA PRADESH,28,1222,22,2009,2058
OTHER,247,0,613,MADHYA PRADESH,1,378,1,2009,625
RAILWAY ACCIDENTS,247,0,1514,MADHYA PRADESH,0,1269,0,2009,1516
DROWNING,1205,3,3864,MADHYA PRADESH,9,2684,6,2009,3889
FALLS,201,1,927,MADHYA PRADESH,11,735,10,2009,936
FIRE,2059,60,2939,MADHYA PRADESH,93,841,33,2009,2900
SUDDEN DEATHS,330,1,1550,MADHYA PRADESH,14,1245,13,2009,1575
POISONING,1947,20,4817,MADHYA PRADESH,69,2915,49,2009,4862
ELECTROCUTION,201,28,1451,MAHARASHTRA,207,1055,179,2009,1256
GAS CYLINDER/STOVE BURST,300,6,378,MAHARASHTRA,8,74,2,2009,374
FIRE-ARMS,0,0,10,MAHARASHTRA,0,12,0,2009,12
SUDDEN DEATHS(HEART ATTACKS),776,1472,9114,MAHARASHTRA,3552,4786,2080,2009,5562
EPILEPTIC FITS/GIDDINESS,317,149,1992,MAHARASHTRA,466,1209,317,2009,1526
ABORTIONS/CHILD BIRTH,323,31,354,MAHARASHTRA,31,0,0,2009,323
INFLUENCE OF ALCOHOL,20,0,1542,MAHARASHTRA,363,1161,363,2009,1181
FOOD POISIONING/ACCIDENTAL INTAKE OF INSECTICIDES ETC.,368,657,2414,MAHARASHTRA,1362,686,705,2009,1054
SNAKE BITE/ANIMAL BITE,484,563,2655,MAHARASHTRA,1537,642,974,2009,1126
OTHER,28,513,1325,MAHARASHTRA,1238,81,725,2009,109
RAILWAY ACCIDENTS,563,435,8226,MAHARASHTRA,3274,4407,2839,2009,4970
DROWNING,1279,41,4810,MAHARASHTRA,111,3519,70,2009,4798
FALLS,317,451,4227,MAHARASHTRA,2083,1860,1632,2009,2177
FIRE,4017,1208,7318,MAHARASHTRA,1842,1519,634,2009,5536
SUDDEN DEATHS,1436,1652,13002,MAHARASHTRA,4412,7156,2760,2009,8592
POISONING,883,1733,6418,MAHARASHTRA,4137,1430,2404,2009,2313
ELECTROCUTION,1,0,5,MANIPUR,0,4,0,2009,5
GAS CYLINDER/STOVE BURST,0,0,0,MANIPUR,0,0,0,2009,0
FIRE-ARMS,0,0,9,MANIPUR,0,9,0,2009,9
SUDDEN DEATHS(HEART ATTACKS),0,0,1,MANIPUR,0,1,0,2009,1
EPILEPTIC FITS/GIDDINESS,0,0,0,MANIPUR,0,0,0,2009,0
ABORTIONS/CHILD BIRTH,0,0,0,MANIPUR,0,0,0,2009,0
INFLUENCE OF ALCOHOL,0,0,0,MANIPUR,0,0,0,2009,0
FOOD POISIONING/ACCIDENTAL INTAKE OF INSECTICIDES ETC.,0,0,0,MANIPUR,0,0,0,2009,0
SNAKE BITE/ANIMAL BITE,0,0,0,MANIPUR,0,0,0,2009,0
OTHER,3,0,10,MANIPUR,0,7,0,2009,10
RAILWAY ACCIDENTS,0,0,0,MANIPUR,0,0,0,2009,0
DROWNING,4,0,6,MANIPUR,0,2,0,2009,6
FALLS,0,0,4,MANIPUR,0,4,0,2009,4
FIRE,1,0,1,MANIPUR,0,0,0,2009,1
SUDDEN DEATHS,0,0,1,MANIPUR,0,1,0,2009,1
POISONING,3,0,10,MANIPUR,0,7,0,2009,10
ELECTROCUTION,0,0,13,MEGHALAYA,5,4,5,2009,4
GAS CYLINDER/STOVE BURST,5,0,5,MEGHALAYA,0,0,0,2009,5
FIRE-ARMS,0,0,1,MEGHALAYA,0,1,0,2009,1
SUDDEN DEATHS(HEART ATTACKS),0,0,1,MEGHALAYA,0,1,0,2009,1
EPILEPTIC FITS/GIDDINESS,0,0,0,MEGHALAYA,0,0,0,2009,0
ABORTIONS/CHILD BIRTH,0,0,0,MEGHALAYA,0,0,0,2009,0
INFLUENCE OF ALCOHOL,0,0,6,MEGHALAYA,0,6,0,2009,6
FOOD POISIONING/ACCIDENTAL INTAKE OF INSECTICIDES ETC.,0,0,0,MEGHALAYA,0,0,0,2009,0
SNAKE BITE/ANIMAL BITE,0,0,0,MEGHALAYA,0,0,0,2009,0
OTHER,1,0,1,MEGHALAYA,0,0,0,2009,1
RAILWAY ACCIDENTS,0,0,0,MEGHALAYA,0,0,0,2009,0
DROWNING,1,0,40,MEGHALAYA,8,42,8,2009,43
FALLS,0,0,13,MEGHALAYA,1,13,1,2009,13
FIRE,11,0,22,MEGHALAYA,3,14,3,2009,25
SUDDEN DEATHS,0,0,7,MEGHALAYA,0,7,0,2009,7
POISONING,1,0,1,MEGHALAYA,0,0,0,2009,1
ELECTROCUTION,0,0,4,MIZORAM,0,4,0,2009,4
GAS CYLINDER/STOVE BURST,0,0,0,MIZORAM,0,0,0,2009,0
FIRE-ARMS,0,0,3,MIZORAM,0,3,0,2009,3
SUDDEN DEATHS(HEART ATTACKS),0,0,1,MIZORAM,0,1,0,2009,1
EPILEPTIC FITS/GIDDINESS,0,0,0,MIZORAM,0,0,0,2009,0
ABORTIONS/CHILD BIRTH,0,0,0,MIZORAM,0,0,0,2009,0
INFLUENCE OF ALCOHOL,0,0,0,MIZORAM,0,0,0,2009,0
FOOD POISIONING/ACCIDENTAL INTAKE OF INSECTICIDES ETC.,0,0,0,MIZORAM,0,0,0,2009,0
SNAKE BITE/ANIMAL BITE,0,0,0,MIZORAM,0,0,0,2009,0
OTHER,0,0,0,MIZORAM,0,0,0,2009,0
RAILWAY ACCIDENTS,0,0,0,MIZORAM,0,0,0,2009,0
DROWNING,2,0,20,MIZORAM,0,21,0,2009,23
FALLS,2,0,7,MIZORAM,0,5,0,2009,7
FIRE,0,0,1,MIZORAM,0,1,0,2009,1
SUDDEN DEATHS,0,0,1,MIZORAM,0,1,0,2009,1
POISONING,0,0,0,MIZORAM,0,0,0,2009,0
ELECTROCUTION,0,0,1,NAGALAND,0,1,0,2009,1
GAS CYLINDER/STOVE BURST,0,0,0,NAGALAND,0,0,0,2009,0
FIRE-ARMS,0,0,3,NAGALAND,0,3,0,2009,3
SUDDEN DEATHS(HEART ATTACKS),0,0,0,NAGALAND,0,0,0,2009,0
EPILEPTIC FITS/GIDDINESS,0,0,0,NAGALAND,0,0,0,2009,0
ABORTIONS/CHILD BIRTH,0,0,0,NAGALAND,0,0,0,2009,0
INFLUENCE OF ALCOHOL,0,0,0,NAGALAND,0,0,0,2009,0
FOOD POISIONING/ACCIDENTAL INTAKE OF INSECTICIDES ETC.,0,0,0,NAGALAND,0,0,0,2009,0
SNAKE BITE/ANIMAL BITE,0,0,0,NAGALAND,0,0,0,2009,0
OTHER,0,0,1,NAGALAND,0,1,0,2009,1
RAILWAY ACCIDENTS,0,0,0,NAGALAND,0,0,0,2009,0
DROWNING,0,0,3,NAGALAND,0,3,0,2009,3
FALLS,0,0,1,NAGALAND,0,1,0,2009,1
FIRE,2,0,2,NAGALAND,0,0,0,2009,2
SUDDEN DEATHS,0,0,0,NAGALAND,0,0,0,2009,0
POISONING,0,0,1,NAGALAND,0,1,0,2009,1
ELECTROCUTION,31,0,216,ODISHA,6,189,6,2009,220
GAS CYLINDER/STOVE BURST,11,0,25,ODISHA,0,14,0,2009,25
FIRE-ARMS,0,0,1,ODISHA,0,1,0,2009,1
SUDDEN DEATHS(HEART ATTACKS),16,0,117,ODISHA,0,102,0,2009,118
EPILEPTIC FITS/GIDDINESS,5,0,21,ODISHA,0,16,0,2009,21
ABORTIONS/CHILD BIRTH,4,0,3,ODISHA,0,0,0,2009,4
INFLUENCE OF ALCOHOL,4,0,22,ODISHA,0,18,0,2009,22
FOOD POISIONING/ACCIDENTAL INTAKE OF INSECTICIDES ETC.,53,0,104,ODISHA,0,52,0,2009,105
SNAKE BITE/ANIMAL BITE,144,0,412,ODISHA,0,268,0,2009,412
OTHER,216,0,530,ODISHA,0,315,0,2009,531
RAILWAY ACCIDENTS,49,0,285,ODISHA,0,240,0,2009,289
DROWNING,144,6,642,ODISHA,6,400,0,2009,544
FALLS,55,0,367,ODISHA,11,307,11,2009,362
FIRE,220,1,534,ODISHA,7,311,6,2009,531
SUDDEN DEATHS,29,0,163,ODISHA,0,136,0,2009,165
POISONING,432,0,1114,ODISHA,0,685,0,2009,1117
ELECTROCUTION,15,0,297,PUNJAB,1,282,1,2009,297
GAS CYLINDER/STOVE BURST,113,0,164,PUNJAB,0,51,0,2009,164
FIRE-ARMS,3,0,15,PUNJAB,0,12,0,2009,15
SUDDEN DEATHS(HEART ATTACKS),51,0,535,PUNJAB,0,486,0,2009,537
EPILEPTIC FITS/GIDDINESS,9,0,78,PUNJAB,0,69,0,2009,78
ABORTIONS/CHILD BIRTH,4,0,4,PUNJAB,0,0,0,2009,4
INFLUENCE OF ALCOHOL,14,0,272,PUNJAB,0,258,0,2009,272
FOOD POISIONING/ACCIDENTAL INTAKE OF INSECTICIDES ETC.,102,0,323,PUNJAB,0,227,0,2009,329
SNAKE BITE/ANIMAL BITE,11,0,68,PUNJAB,0,57,0,2009,68
OTHER,59,0,192,PUNJAB,0,133,0,2009,192
RAILWAY ACCIDENTS,113,0,832,PUNJAB,1,719,1,2009,832
DROWNING,81,0,592,PUNJAB,0,511,0,2009,592
FALLS,16,0,223,PUNJAB,0,207,0,2009,223
FIRE,223,1,369,PUNJAB,1,148,0,2009,371
SUDDEN DEATHS,78,0,889,PUNJAB,0,813,0,2009,891
POISONING,217,0,785,PUNJAB,0,574,0,2009,791
ELECTROCUTION,61,6,624,RAJASTHAN,15,570,9,2009,631
GAS CYLINDER/STOVE BURST,120,1,159,RAJASTHAN,10,43,9,2009,163
FIRE-ARMS,3,0,8,RAJASTHAN,0,6,0,2009,9
SUDDEN DEATHS(HEART ATTACKS),63,7,581,RAJASTHAN,12,506,5,2009,569
EPILEPTIC FITS/GIDDINESS,21,0,98,RAJASTHAN,0,77,0,2009,98
ABORTIONS/CHILD BIRTH,19,0,19,RAJASTHAN,0,0,0,2009,19
INFLUENCE OF ALCOHOL,0,0,188,RAJASTHAN,0,188,0,2009,188
FOOD POISIONING/ACCIDENTAL INTAKE OF INSECTICIDES ETC.,270,1,771,RAJASTHAN,1,561,0,2009,831
SNAKE BITE/ANIMAL BITE,97,0,295,RAJASTHAN,0,198,0,2009,295
OTHER,158,0,559,RAJASTHAN,0,440,0,2009,598
RAILWAY ACCIDENTS,53,0,368,RAJASTHAN,0,318,0,2009,371
DROWNING,359,2,1228,RAJASTHAN,6,989,4,2009,1348
FALLS,139,0,644,RAJASTHAN,0,511,0,2009,650
FIRE,445,8,772,RAJASTHAN,29,341,21,2009,786
SUDDEN DEATHS,103,7,886,RAJASTHAN,12,771,5,2009,874
POISONING,528,1,1630,RAJASTHAN,1,1212,0,2009,1740
ELECTROCUTION,2,0,6,SIKKIM,0,4,0,2009,6
GAS CYLINDER/STOVE BURST,0,0,0,SIKKIM,0,0,0,2009,0
FIRE-ARMS,0,0,0,SIKKIM,0,0,0,2009,0
SUDDEN DEATHS(HEART ATTACKS),0,0,0,SIKKIM,0,0,0,2009,0
EPILEPTIC FITS/GIDDINESS,0,0,2,SIKKIM,0,2,0,2009,2
ABORTIONS/CHILD BIRTH,0,0,0,SIKKIM,0,0,0,2009,0
INFLUENCE OF ALCOHOL,2,0,3,SIKKIM,0,1,0,2009,3
FOOD POISIONING/ACCIDENTAL INTAKE OF INSECTICIDES ETC.,0,0,0,SIKKIM,0,0,0,2009,0
SNAKE BITE/ANIMAL BITE,0,0,0,SIKKIM,0,0,0,2009,0
OTHER,2,0,8,SIKKIM,0,6,0,2009,8
RAILWAY ACCIDENTS,0,0,0,SIKKIM,0,0,0,2009,0
DROWNING,5,0,30,SIKKIM,0,25,0,2009,30
FALLS,3,0,48,SIKKIM,0,45,0,2009,48
FIRE,5,0,7,SIKKIM,0,2,0,2009,7
SUDDEN DEATHS,2,0,5,SIKKIM,0,3,0,2009,5
POISONING,2,0,8,SIKKIM,0,6,0,2009,8
ELECTROCUTION,84,1,467,TAMIL NADU,4,406,3,2009,490
GAS CYLINDER/STOVE BURST,587,2,695,TAMIL NADU,6,169,4,2009,756
FIRE-ARMS,0,0,0,TAMIL NADU,0,0,0,2009,0
SUDDEN DEATHS(HEART ATTACKS),185,0,0,TAMIL NADU,0,1041,0,2009,1226
EPILEPTIC FITS/GIDDINESS,62,0,1125,TAMIL NADU,3,220,3,2009,282
ABORTIONS/CHILD BIRTH,28,1,252,TAMIL NADU,1,0,0,2009,28
INFLUENCE OF ALCOHOL,13,0,13,TAMIL NADU,0,186,0,2009,199
FOOD POISIONING/ACCIDENTAL INTAKE OF INSECTICIDES ETC.,89,0,115,TAMIL NADU,0,205,0,2009,294
SNAKE BITE/ANIMAL BITE,250,0,5,TAMIL NADU,0,394,0,2009,644
OTHER,505,0,589,TAMIL NADU,0,931,0,2009,1436
RAILWAY ACCIDENTS,333,4,1613,TAMIL NADU,13,1496,9,2009,1829
DROWNING,338,1,1403,TAMIL NADU,3,1264,2,2009,1602
FALLS,15,0,58,TAMIL NADU,2,56,2,2009,71
FIRE,1708,32,1887,TAMIL NADU,66,807,34,2009,2515
SUDDEN DEATHS,288,1,1390,TAMIL NADU,4,1447,3,2009,1735
POISONING,983,0,1243,TAMIL NADU,0,1838,0,2009,2821
ELECTROCUTION,4,0,34,TRIPURA,0,31,0,2009,35
GAS CYLINDER/STOVE BURST,0,0,0,TRIPURA,0,0,0,2009,0
FIRE-ARMS,0,0,0,TRIPURA,0,0,0,2009,0
SUDDEN DEATHS(HEART ATTACKS),13,0,52,TRIPURA,0,39,0,2009,52
EPILEPTIC FITS/GIDDINESS,0,0,2,TRIPURA,0,2,0,2009,2
ABORTIONS/CHILD BIRTH,2,0,2,TRIPURA,0,0,0,2009,2
INFLUENCE OF ALCOHOL,0,0,12,TRIPURA,0,12,0,2009,12
FOOD POISIONING/ACCIDENTAL INTAKE OF INSECTICIDES ETC.,2,0,2,TRIPURA,0,0,0,2009,2
SNAKE BITE/ANIMAL BITE,0,0,0,TRIPURA,0,0,0,2009,0
OTHER,0,0,0,TRIPURA,0,0,0,2009,0
RAILWAY ACCIDENTS,3,0,8,TRIPURA,0,10,0,2009,13
DROWNING,17,0,61,TRIPURA,0,47,0,2009,64
FALLS,0,0,13,TRIPURA,0,13,0,2009,13
FIRE,15,0,29,TRIPURA,0,14,0,2009,29
SUDDEN DEATHS,15,0,68,TRIPURA,0,53,0,2009,68
POISONING,2,0,3,TRIPURA,0,1,0,2009,3
ELECTROCUTION,77,19,515,UTTAR PRADESH,76,427,57,2009,504
GAS CYLINDER/STOVE BURST,83,24,114,UTTAR PRADESH,31,28,7,2009,111
FIRE-ARMS,158,95,1200,UTTAR PRADESH,547,818,452,2009,976
SUDDEN DEATHS(HEART ATTACKS),34,3,246,UTTAR PRADESH,9,211,6,2009,245
EPILEPTIC FITS/GIDDINESS,14,3,57,UTTAR PRADESH,11,41,8,2009,55
ABORTIONS/CHILD BIRTH,48,5,48,UTTAR PRADESH,5,0,0,2009,48
INFLUENCE OF ALCOHOL,9,2,178,UTTAR PRADESH,36,165,34,2009,174
FOOD POISIONING/ACCIDENTAL INTAKE OF INSECTICIDES ETC.,233,19,557,UTTAR PRADESH,53,311,34,2009,544
SNAKE BITE/ANIMAL BITE,24,6,115,UTTAR PRADESH,19,85,13,2009,109
OTHER,77,14,280,UTTAR PRADESH,88,195,74,2009,272
RAILWAY ACCIDENTS,495,48,2673,UTTAR PRADESH,62,2330,14,2009,2825
DROWNING,251,36,953,UTTAR PRADESH,121,665,85,2009,916
FALLS,61,18,379,UTTAR PRADESH,85,309,67,2009,370
FIRE,730,104,1194,UTTAR PRADESH,225,326,121,2009,1056
SUDDEN DEATHS,105,13,529,UTTAR PRADESH,61,417,48,2009,522
POISONING,342,43,1057,UTTAR PRADESH,229,681,186,2009,1023
ELECTROCUTION,5,3,46,UTTARAKHAND,7,38,4,2009,43
GAS CYLINDER/STOVE BURST,21,3,28,UTTARAKHAND,7,5,4,2009,26
FIRE-ARMS,0,0,18,UTTARAKHAND,0,18,0,2009,18
SUDDEN DEATHS(HEART ATTACKS),27,0,126,UTTARAKHAND,0,99,0,2009,126
EPILEPTIC FITS/GIDDINESS,6,0,10,UTTARAKHAND,0,7,0,2009,13
ABORTIONS/CHILD BIRTH,7,0,7,UTTARAKHAND,0,0,0,2009,7
INFLUENCE OF ALCOHOL,0,1,21,UTTARAKHAND,2,20,1,2009,20
FOOD POISIONING/ACCIDENTAL INTAKE OF INSECTICIDES ETC.,46,2,90,UTTARAKHAND,2,52,0,2009,98
SNAKE BITE/ANIMAL BITE,2,0,7,UTTARAKHAND,1,4,1,2009,6
OTHER,7,0,27,UTTARAKHAND,0,20,0,2009,27
RAILWAY ACCIDENTS,8,0,58,UTTARAKHAND,0,50,0,2009,58
DROWNING,57,7,144,UTTARAKHAND,15,122,8,2009,179
FALLS,17,6,86,UTTARAKHAND,9,70,3,2009,87
FIRE,40,7,85,UTTARAKHAND,28,25,21,2009,65
SUDDEN DEATHS,40,1,164,UTTARAKHAND,2,126,1,2009,166
POISONING,57,2,132,UTTARAKHAND,3,82,1,2009,139
ELECTROCUTION,24,4,99,WEST BENGAL,16,75,12,2009,99
GAS CYLINDER/STOVE BURST,53,21,68,WEST BENGAL,25,5,4,2009,58
FIRE-ARMS,1,1,53,WEST BENGAL,17,44,16,2009,45
SUDDEN DEATHS(HEART ATTACKS),170,54,846,WEST BENGAL,195,479,141,2009,649
EPILEPTIC FITS/GIDDINESS,2,0,4,WEST BENGAL,2,0,2,2009,2
ABORTIONS/CHILD BIRTH,31,0,31,WEST BENGAL,0,0,0,2009,31
INFLUENCE OF ALCOHOL,1,0,96,WEST BENGAL,45,47,45,2009,48
FOOD POISIONING/ACCIDENTAL INTAKE OF INSECTICIDES ETC.,110,12,231,WEST BENGAL,33,119,21,2009,229
SNAKE BITE/ANIMAL BITE,93,41,222,WEST BENGAL,109,119,68,2009,212
OTHER,361,51,829,WEST BENGAL,144,502,93,2009,863
RAILWAY ACCIDENTS,529,1,2602,WEST BENGAL,4,2075,3,2009,2604
DROWNING,175,29,477,WEST BENGAL,89,396,60,2009,571
FALLS,27,4,135,WEST BENGAL,23,124,19,2009,151
FIRE,279,75,581,WEST BENGAL,195,120,120,2009,399
SUDDEN DEATHS,204,54,977,WEST BENGAL,242,526,188,2009,730
POISONING,617,114,1391,WEST BENGAL,317,823,203,2009,1440
ELECTROCUTION,0,0,1,A & N ISLANDS,0,1,0,2009,1
GAS CYLINDER/STOVE BURST,0,0,0,A & N ISLANDS,0,0,0,2009,0
FIRE-ARMS,0,0,0,A & N ISLANDS,0,0,0,2009,0
SUDDEN DEATHS(HEART ATTACKS),2,0,18,A & N ISLANDS,0,16,0,2009,18
EPILEPTIC FITS/GIDDINESS,0,0,0,A & N ISLANDS,0,0,0,2009,0
ABORTIONS/CHILD BIRTH,0,0,0,A & N ISLANDS,0,0,0,2009,0
INFLUENCE OF ALCOHOL,0,0,0,A & N ISLANDS,0,0,0,2009,0
FOOD POISIONING/ACCIDENTAL INTAKE OF INSECTICIDES ETC.,0,0,1,A & N ISLANDS,0,1,0,2009,1
SNAKE BITE/ANIMAL BITE,0,0,1,A & N ISLANDS,0,1,0,2009,1
OTHER,0,0,1,A & N ISLANDS,0,1,0,2009,1
RAILWAY ACCIDENTS,0,0,0,A & N ISLANDS,0,0,0,2009,0
DROWNING,2,0,27,A & N ISLANDS,0,29,0,2009,31
FALLS,2,0,24,A & N ISLANDS,0,22,0,2009,24
FIRE,19,0,21,A & N ISLANDS,0,2,0,2009,21
SUDDEN DEATHS,2,0,18,A & N ISLANDS,0,16,0,2009,18
POISONING,0,0,3,A & N ISLANDS,0,3,0,2009,3
ELECTROCUTION,1,0,6,CHANDIGARH,0,5,0,2009,6
GAS CYLINDER/STOVE BURST,5,0,10,CHANDIGARH,0,5,0,2009,10
FIRE-ARMS,0,0,1,CHANDIGARH,0,1,0,2009,1
SUDDEN DEATHS(HEART ATTACKS),1,0,35,CHANDIGARH,0,34,0,2009,35
EPILEPTIC FITS/GIDDINESS,1,0,1,CHANDIGARH,0,0,0,2009,1
ABORTIONS/CHILD BIRTH,1,0,1,CHANDIGARH,0,0,0,2009,1
INFLUENCE OF ALCOHOL,1,0,15,CHANDIGARH,0,14,0,2009,15
FOOD POISIONING/ACCIDENTAL INTAKE OF INSECTICIDES ETC.,0,0,0,CHANDIGARH,0,0,0,2009,0
SNAKE BITE/ANIMAL BITE,0,0,1,CHANDIGARH,0,1,0,2009,1
OTHER,2,0,6,CHANDIGARH,0,4,0,2009,6
RAILWAY ACCIDENTS,0,0,0,CHANDIGARH,0,0,0,2009,0
DROWNING,0,0,1,CHANDIGARH,0,1,0,2009,1
FALLS,0,0,13,CHANDIGARH,0,13,0,2009,13
FIRE,5,0,17,CHANDIGARH,0,12,0,2009,17
SUDDEN DEATHS,4,0,52,CHANDIGARH,0,48,0,2009,52
POISONING,2,0,8,CHANDIGARH,0,6,0,2009,8
ELECTROCUTION,1,0,11,D & N HAVELI,0,10,0,2009,11
GAS CYLINDER/STOVE BURST,10,0,13,D & N HAVELI,0,3,0,2009,13
FIRE-ARMS,0,0,0,D & N HAVELI,0,0,0,2009,0
SUDDEN DEATHS(HEART ATTACKS),4,0,20,D & N HAVELI,0,16,0,2009,20
EPILEPTIC FITS/GIDDINESS,0,0,2,D & N HAVELI,0,2,0,2009,2
ABORTIONS/CHILD BIRTH,0,0,0,D & N HAVELI,0,0,0,2009,0
INFLUENCE OF ALCOHOL,0,0,5,D & N HAVELI,0,5,0,2009,5
FOOD POISIONING/ACCIDENTAL INTAKE OF INSECTICIDES ETC.,0,0,0,D & N HAVELI,0,0,0,2009,0
SNAKE BITE/ANIMAL BITE,3,0,10,D & N HAVELI,0,7,0,2009,10
OTHER,0,0,0,D & N HAVELI,0,0,0,2009,0
RAILWAY ACCIDENTS,0,0,0,D & N HAVELI,0,0,0,2009,0
DROWNING,4,0,13,D & N HAVELI,0,10,0,2009,14
FALLS,1,0,16,D & N HAVELI,0,15,0,2009,16
FIRE,10,0,13,D & N HAVELI,0,3,0,2009,13
SUDDEN DEATHS,4,0,27,D & N HAVELI,0,23,0,2009,27
POISONING,3,0,10,D & N HAVELI,0,7,0,2009,10
ELECTROCUTION,0,0,5,DAMAN & DIU,0,5,0,2009,5
GAS CYLINDER/STOVE BURST,0,0,0,DAMAN & DIU,0,0,0,2009,0
FIRE-ARMS,0,0,0,DAMAN & DIU,0,0,0,2009,0
SUDDEN DEATHS(HEART ATTACKS),0,0,6,DAMAN & DIU,0,6,0,2009,6
EPILEPTIC FITS/GIDDINESS,0,0,3,DAMAN & DIU,0,3,0,2009,3
ABORTIONS/CHILD BIRTH,0,0,0,DAMAN & DIU,0,0,0,2009,0
INFLUENCE OF ALCOHOL,0,0,0,DAMAN & DIU,0,0,0,2009,0
FOOD POISIONING/ACCIDENTAL INTAKE OF INSECTICIDES ETC.,0,0,0,DAMAN & DIU,0,0,0,2009,0
SNAKE BITE/ANIMAL BITE,0,0,0,DAMAN & DIU,0,0,0,2009,0
OTHER,0,0,0,DAMAN & DIU,0,0,0,2009,0
RAILWAY ACCIDENTS,0,0,0,DAMAN & DIU,0,0,0,2009,0
DROWNING,1,0,17,DAMAN & DIU,0,16,0,2009,17
FALLS,0,0,8,DAMAN & DIU,0,8,0,2009,8
FIRE,4,0,6,DAMAN & DIU,0,2,0,2009,6
SUDDEN DEATHS,0,0,9,DAMAN & DIU,0,9,0,2009,9
POISONING,0,0,0,DAMAN & DIU,0,0,0,2009,0
ELECTROCUTION,18,0,169,DELHI(UT),16,145,16,2009,163
GAS CYLINDER/STOVE BURST,69,11,98,DELHI(UT),41,28,30,2009,97
FIRE-ARMS,7,2,81,DELHI(UT),47,39,45,2009,46
SUDDEN DEATHS(HEART ATTACKS),22,0,242,DELHI(UT),1,223,1,2009,245
EPILEPTIC FITS/GIDDINESS,6,0,27,DELHI(UT),0,21,0,2009,27
ABORTIONS/CHILD BIRTH,18,0,18,DELHI(UT),0,0,0,2009,18
INFLUENCE OF ALCOHOL,5,0,151,DELHI(UT),0,155,0,2009,160
FOOD POISIONING/ACCIDENTAL INTAKE OF INSECTICIDES ETC.,12,0,51,DELHI(UT),0,40,0,2009,52
SNAKE BITE/ANIMAL BITE,3,0,6,DELHI(UT),0,3,0,2009,6
OTHER,55,0,166,DELHI(UT),4,112,4,2009,167
RAILWAY ACCIDENTS,99,26,1331,DELHI(UT),380,852,354,2009,951
DROWNING,16,0,95,DELHI(UT),0,85,0,2009,101
FALLS,88,4,442,DELHI(UT),32,341,28,2009,429
FIRE,230,15,369,DELHI(UT),71,173,56,2009,403
SUDDEN DEATHS,51,0,438,DELHI(UT),1,399,1,2009,450
POISONING,72,0,248,DELHI(UT),5,177,5,2009,249
ELECTROCUTION,0,0,0,LAKSHADWEEP,0,0,0,2009,0
GAS CYLINDER/STOVE BURST,0,0,0,LAKSHADWEEP,0,0,0,2009,0
FIRE-ARMS,0,0,0,LAKSHADWEEP,0,0,0,2009,0
SUDDEN DEATHS(HEART ATTACKS),0,0,0,LAKSHADWEEP,0,0,0,2009,0
EPILEPTIC FITS/GIDDINESS,0,0,0,LAKSHADWEEP,0,0,0,2009,0
ABORTIONS/CHILD BIRTH,0,0,0,LAKSHADWEEP,0,0,0,2009,0
INFLUENCE OF ALCOHOL,0,0,0,LAKSHADWEEP,0,0,0,2009,0
FOOD POISIONING/ACCIDENTAL INTAKE OF INSECTICIDES ETC.,0,0,0,LAKSHADWEEP,0,0,0,2009,0
SNAKE BITE/ANIMAL BITE,0,0,0,LAKSHADWEEP,0,0,0,2009,0
OTHER,0,0,0,LAKSHADWEEP,0,0,0,2009,0
RAILWAY ACCIDENTS,0,0,0,LAKSHADWEEP,0,0,0,2009,0
DROWNING,2,0,4,LAKSHADWEEP,0,3,0,2009,5
FALLS,0,0,0,LAKSHADWEEP,0,0,0,2009,0
FIRE,1,0,1,LAKSHADWEEP,0,0,0,2009,1
SUDDEN DEATHS,0,0,0,LAKSHADWEEP,0,0,0,2009,0
POISONING,0,0,0,LAKSHADWEEP,0,0,0,2009,0
ELECTROCUTION,6,0,42,PUDUCHERRY,4,32,4,2009,38
GAS CYLINDER/STOVE BURST,0,0,0,PUDUCHERRY,0,0,0,2009,0
FIRE-ARMS,0,0,0,PUDUCHERRY,0,0,0,2009,0
SUDDEN DEATHS(HEART ATTACKS),1,0,52,PUDUCHERRY,0,51,0,2009,52
EPILEPTIC FITS/GIDDINESS,24,0,187,PUDUCHERRY,0,163,0,2009,187
ABORTIONS/CHILD BIRTH,0,0,0,PUDUCHERRY,0,0,0,2009,0
INFLUENCE OF ALCOHOL,8,0,210,PUDUCHERRY,0,202,0,2009,210
FOOD POISIONING/ACCIDENTAL INTAKE OF INSECTICIDES ETC.,0,0,3,PUDUCHERRY,0,3,0,2009,3
SNAKE BITE/ANIMAL BITE,7,0,10,PUDUCHERRY,0,3,0,2009,10
OTHER,1,0,5,PUDUCHERRY,0,4,0,2009,5
RAILWAY ACCIDENTS,0,0,5,PUDUCHERRY,0,5,0,2009,5
DROWNING,6,0,89,PUDUCHERRY,0,83,0,2009,89
FALLS,6,0,51,PUDUCHERRY,4,41,4,2009,47
FIRE,34,1,46,PUDUCHERRY,2,10,1,2009,44
SUDDEN DEATHS,33,0,449,PUDUCHERRY,0,416,0,2009,449
POISONING,8,0,18,PUDUCHERRY,0,10,0,2009,18
