FEMALE KILLED,YEAR,MALE KILLED,STATE/UT,CASES,FEMALE INJURED,MALE INJURED,TOTAL INJURED,TOTAL KILLED,CAUSE
160,2011,810,ANDHRA PRADESH,961,1,2,3,970,ELECTROCUTION
337,2011,89,ANDHRA PRADESH,441,46,10,56,426,GAS CYLINDER/STOVE BURST
3,2011,1,ANDHRA PRADESH,4,0,0,0,4,FIRE-ARMS
122,2011,368,ANDHRA PRADESH,490,0,0,0,490,SUDDEN DEATHS(HEART ATTACKS)
50,2011,85,ANDHRA PRADESH,135,0,0,0,135,EPILEPTIC FITS/GIDDINESS
11,2011,0,ANDHRA PRADESH,11,0,0,0,11,ABORTIONS/CHILD BIRTH
10,2011,220,ANDHRA PRADESH,230,0,0,0,230,INFLUENCE OF ALCOHOL
84,2011,226,ANDHRA PRADESH,274,5,5,10,310,FOOD POISIONING/ACCIDENTAL INTAKE OF INSECTICIDES ETC.
269,2011,486,ANDHRA PRADESH,750,0,1,1,755,SNAKE BITE/ANIMAL BITE
368,2011,1206,ANDHRA PRADESH,1549,18,32,50,1574,OTHER
300,2011,1070,ANDHRA PRADESH,1362,0,0,0,1370,OTHER RAILWAY ACCIDENTS
563,2011,2292,ANDHRA PRADESH,2751,9,21,30,2855,TOTAL DROWNING
195,2011,1056,ANDHRA PRADESH,1251,7,15,22,1251,TOTAL FALLS
1159,2011,906,ANDHRA PRADESH,2051,73,38,111,2065,TOTAL FIRE
193,2011,673,ANDHRA PRADESH,866,0,0,0,866,TOTAL SUDDEN DEATHS
730,2011,1989,ANDHRA PRADESH,2651,23,38,61,2719,TOTAL POISONING
3,2011,5,ARUNACHAL PRADESH,8,0,0,0,8,ELECTROCUTION
0,2011,0,ARUNACHAL PRADESH,0,0,0,0,0,GAS CYLINDER/STOVE BURST
0,2011,6,ARUNACHAL PRADESH,5,0,0,0,6,FIRE-ARMS
0,2011,5,ARUNACHAL PRADESH,5,0,0,0,5,SUDDEN DEATHS(HEART ATTACKS)
0,2011,2,ARUNACHAL PRADESH,2,0,0,0,2,EPILEPTIC FITS/GIDDINESS
0,2011,0,ARUNACHAL PRADESH,0,0,0,0,0,ABORTIONS/CHILD BIRTH
0,2011,4,ARUNACHAL PRADESH,4,0,0,0,4,INFLUENCE OF ALCOHOL
0,2011,0,ARUNACHAL PRADESH,0,0,0,0,0,FOOD POISIONING/ACCIDENTAL INTAKE OF INSECTICIDES ETC.
0,2011,0,ARUNACHAL PRADESH,0,0,0,0,0,SNAKE BITE/ANIMAL BITE
3,2011,13,ARUNACHAL PRADESH,16,0,0,0,16,OTHER
0,2011,0,ARUNACHAL PRADESH,0,0,0,0,0,OTHER RAILWAY ACCIDENTS
4,2011,14,ARUNACHAL PRADESH,17,0,0,0,18,TOTAL DROWNING
3,2011,21,ARUNACHAL PRADESH,24,0,0,0,24,TOTAL FALLS
3,2011,10,ARUNACHAL PRADESH,12,0,0,0,13,TOTAL FIRE
0,2011,11,ARUNACHAL PRADESH,11,0,0,0,11,TOTAL SUDDEN DEATHS
3,2011,13,ARUNACHAL PRADESH,16,0,0,0,16,TOTAL POISONING
9,2011,90,ASSAM,98,0,0,0,99,ELECTROCUTION
14,2011,2,ASSAM,17,0,1,1,16,GAS CYLINDER/STOVE BURST
1,2011,18,ASSAM,16,0,2,2,19,FIRE-ARMS
11,2011,36,ASSAM,47,0,0,0,47,SUDDEN DEATHS(HEART ATTACKS)
0,2011,0,ASSAM,0,0,0,0,0,EPILEPTIC FITS/GIDDINESS
10,2011,0,ASSAM,10,0,0,0,10,ABORTIONS/CHILD BIRTH
0,2011,0,ASSAM,0,0,0,0,0,INFLUENCE OF ALCOHOL
15,2011,14,ASSAM,32,3,0,3,29,FOOD POISIONING/ACCIDENTAL INTAKE OF INSECTICIDES ETC.
1,2011,6,ASSAM,7,0,0,0,7,SNAKE BITE/ANIMAL BITE
45,2011,56,ASSAM,100,0,0,0,101,OTHER
54,2011,429,ASSAM,482,0,0,0,483,OTHER RAILWAY ACCIDENTS
91,2011,277,ASSAM,343,0,0,0,368,TOTAL DROWNING
0,2011,38,ASSAM,38,0,0,0,38,TOTAL FALLS
120,2011,45,ASSAM,166,0,1,1,165,TOTAL FIRE
21,2011,36,ASSAM,57,0,0,0,57,TOTAL SUDDEN DEATHS
61,2011,77,ASSAM,140,3,0,3,138,TOTAL POISONING
32,2011,181,BIHAR,195,10,32,42,213,ELECTROCUTION
126,2011,21,BIHAR,166,32,27,59,147,GAS CYLINDER/STOVE BURST
5,2011,15,BIHAR,23,2,7,9,20,FIRE-ARMS
20,2011,80,BIHAR,95,1,1,2,100,SUDDEN DEATHS(HEART ATTACKS)
8,2011,21,BIHAR,41,6,8,14,29,EPILEPTIC FITS/GIDDINESS
9,2011,0,BIHAR,9,0,0,0,9,ABORTIONS/CHILD BIRTH
3,2011,126,BIHAR,136,0,22,22,129,INFLUENCE OF ALCOHOL
161,2011,261,BIHAR,434,30,34,64,422,FOOD POISIONING/ACCIDENTAL INTAKE OF INSECTICIDES ETC.
15,2011,46,BIHAR,62,0,3,3,61,SNAKE BITE/ANIMAL BITE
114,2011,178,BIHAR,304,27,53,80,292,OTHER
290,2011,1554,BIHAR,1831,0,0,0,1844,OTHER RAILWAY ACCIDENTS
133,2011,390,BIHAR,503,28,62,90,523,TOTAL DROWNING
15,2011,103,BIHAR,137,9,22,31,118,TOTAL FALLS
412,2011,241,BIHAR,628,75,94,169,653,TOTAL FIRE
40,2011,227,BIHAR,281,7,31,38,267,TOTAL SUDDEN DEATHS
298,2011,534,BIHAR,848,62,98,160,832,TOTAL POISONING
86,2011,405,CHHATTISGARH,491,0,1,1,491,ELECTROCUTION
26,2011,6,CHHATTISGARH,32,0,0,0,32,GAS CYLINDER/STOVE BURST
6,2011,90,CHHATTISGARH,109,0,13,13,96,FIRE-ARMS
50,2011,229,CHHATTISGARH,279,0,0,0,279,SUDDEN DEATHS(HEART ATTACKS)
11,2011,66,CHHATTISGARH,77,0,0,0,77,EPILEPTIC FITS/GIDDINESS
13,2011,0,CHHATTISGARH,13,0,0,0,13,ABORTIONS/CHILD BIRTH
31,2011,239,CHHATTISGARH,270,0,0,0,270,INFLUENCE OF ALCOHOL
270,2011,414,CHHATTISGARH,684,0,0,0,684,FOOD POISIONING/ACCIDENTAL INTAKE OF INSECTICIDES ETC.
385,2011,438,CHHATTISGARH,823,0,0,0,823,SNAKE BITE/ANIMAL BITE
142,2011,272,CHHATTISGARH,414,0,0,0,414,OTHER
108,2011,500,CHHATTISGARH,584,0,0,0,608,OTHER RAILWAY ACCIDENTS
502,2011,1183,CHHATTISGARH,1685,1,0,1,1685,TOTAL DROWNING
91,2011,384,CHHATTISGARH,475,0,0,0,475,TOTAL FALLS
715,2011,278,CHHATTISGARH,993,0,0,0,993,TOTAL FIRE
105,2011,534,CHHATTISGARH,639,0,0,0,639,TOTAL SUDDEN DEATHS
797,2011,1126,CHHATTISGARH,1923,0,0,0,1923,TOTAL POISONING
2,2011,19,GOA,21,0,0,0,21,ELECTROCUTION
5,2011,0,GOA,5,0,0,0,5,GAS CYLINDER/STOVE BURST
0,2011,0,GOA,1,0,1,1,0,FIRE-ARMS
2,2011,7,GOA,9,0,0,0,9,SUDDEN DEATHS(HEART ATTACKS)
0,2011,4,GOA,4,0,0,0,4,EPILEPTIC FITS/GIDDINESS
0,2011,0,GOA,0,0,0,0,0,ABORTIONS/CHILD BIRTH
0,2011,6,GOA,6,0,0,0,6,INFLUENCE OF ALCOHOL
2,2011,3,GOA,5,0,0,0,5,FOOD POISIONING/ACCIDENTAL INTAKE OF INSECTICIDES ETC.
0,2011,4,GOA,4,0,0,0,4,SNAKE BITE/ANIMAL BITE
0,2011,2,GOA,2,0,0,0,2,OTHER
1,2011,41,GOA,42,0,0,0,42,OTHER RAILWAY ACCIDENTS
12,2011,136,GOA,148,0,0,0,148,TOTAL DROWNING
10,2011,103,GOA,113,0,0,0,113,TOTAL FALLS
24,2011,16,GOA,37,0,1,1,40,TOTAL FIRE
2,2011,17,GOA,19,0,0,0,19,TOTAL SUDDEN DEATHS
2,2011,9,GOA,11,0,0,0,11,TOTAL POISONING
125,2011,466,GUJARAT,596,2,10,12,591,ELECTROCUTION
559,2011,176,GUJARAT,762,21,8,29,735,GAS CYLINDER/STOVE BURST
2,2011,1,GUJARAT,3,0,0,0,3,FIRE-ARMS
211,2011,1750,GUJARAT,1952,0,0,0,1961,SUDDEN DEATHS(HEART ATTACKS)
105,2011,489,GUJARAT,594,0,0,0,594,EPILEPTIC FITS/GIDDINESS
39,2011,0,GUJARAT,39,0,0,0,39,ABORTIONS/CHILD BIRTH
2,2011,21,GUJARAT,23,0,0,0,23,INFLUENCE OF ALCOHOL
126,2011,243,GUJARAT,491,59,79,138,369,FOOD POISIONING/ACCIDENTAL INTAKE OF INSECTICIDES ETC.
206,2011,341,GUJARAT,569,13,25,38,547,SNAKE BITE/ANIMAL BITE
155,2011,191,GUJARAT,341,0,0,0,346,OTHER
141,2011,929,GUJARAT,1070,0,0,0,1070,OTHER RAILWAY ACCIDENTS
356,2011,1597,GUJARAT,1911,2,7,9,1953,TOTAL DROWNING
189,2011,1056,GUJARAT,1268,7,20,27,1245,TOTAL FALLS
1666,2011,848,GUJARAT,2588,73,37,110,2514,TOTAL FIRE
357,2011,2260,GUJARAT,2608,0,0,0,2617,TOTAL SUDDEN DEATHS
556,2011,983,GUJARAT,1674,72,104,176,1539,TOTAL POISONING
28,2011,318,HARYANA,346,0,0,0,346,ELECTROCUTION
112,2011,58,HARYANA,170,0,0,0,170,GAS CYLINDER/STOVE BURST
0,2011,3,HARYANA,3,0,0,0,3,FIRE-ARMS
49,2011,505,HARYANA,554,0,0,0,554,SUDDEN DEATHS(HEART ATTACKS)
12,2011,60,HARYANA,72,0,0,0,72,EPILEPTIC FITS/GIDDINESS
17,2011,0,HARYANA,17,0,0,0,17,ABORTIONS/CHILD BIRTH
3,2011,306,HARYANA,309,0,0,0,309,INFLUENCE OF ALCOHOL
100,2011,252,HARYANA,352,0,0,0,352,FOOD POISIONING/ACCIDENTAL INTAKE OF INSECTICIDES ETC.
11,2011,72,HARYANA,83,0,0,0,83,SNAKE BITE/ANIMAL BITE
48,2011,204,HARYANA,252,0,0,0,252,OTHER
124,2011,1128,HARYANA,1252,0,0,0,1252,OTHER RAILWAY ACCIDENTS
75,2011,501,HARYANA,574,0,0,0,576,TOTAL DROWNING
31,2011,259,HARYANA,290,0,0,0,290,TOTAL FALLS
185,2011,185,HARYANA,370,0,0,0,370,TOTAL FIRE
81,2011,871,HARYANA,952,0,0,0,952,TOTAL SUDDEN DEATHS
164,2011,538,HARYANA,702,0,0,0,702,TOTAL POISONING
1,2011,14,HIMACHAL PRADESH,16,0,1,1,15,ELECTROCUTION
6,2011,1,HIMACHAL PRADESH,7,1,0,1,7,GAS CYLINDER/STOVE BURST
0,2011,4,HIMACHAL PRADESH,4,0,0,0,4,FIRE-ARMS
13,2011,153,HIMACHAL PRADESH,166,0,0,0,166,SUDDEN DEATHS(HEART ATTACKS)
0,2011,2,HIMACHAL PRADESH,2,0,0,0,2,EPILEPTIC FITS/GIDDINESS
4,2011,0,HIMACHAL PRADESH,4,0,0,0,4,ABORTIONS/CHILD BIRTH
0,2011,76,HIMACHAL PRADESH,76,0,0,0,76,INFLUENCE OF ALCOHOL
45,2011,61,HIMACHAL PRADESH,106,0,0,0,106,FOOD POISIONING/ACCIDENTAL INTAKE OF INSECTICIDES ETC.
7,2011,10,HIMACHAL PRADESH,17,0,0,0,17,SNAKE BITE/ANIMAL BITE
19,2011,35,HIMACHAL PRADESH,54,0,0,0,54,OTHER
5,2011,22,HIMACHAL PRADESH,27,0,0,0,27,OTHER RAILWAY ACCIDENTS
36,2011,120,HIMACHAL PRADESH,155,0,0,0,156,TOTAL DROWNING
43,2011,298,HIMACHAL PRADESH,341,0,0,0,341,TOTAL FALLS
34,2011,38,HIMACHAL PRADESH,69,1,0,1,72,TOTAL FIRE
17,2011,231,HIMACHAL PRADESH,248,0,0,0,248,TOTAL SUDDEN DEATHS
71,2011,107,HIMACHAL PRADESH,178,0,0,0,178,TOTAL POISONING
3,2011,14,JAMMU & KASHMIR,17,0,3,3,17,ELECTROCUTION
4,2011,1,JAMMU & KASHMIR,8,3,1,4,5,GAS CYLINDER/STOVE BURST
1,2011,15,JAMMU & KASHMIR,18,0,5,5,16,FIRE-ARMS
7,2011,56,JAMMU & KASHMIR,63,0,0,0,63,SUDDEN DEATHS(HEART ATTACKS)
0,2011,2,JAMMU & KASHMIR,2,0,0,0,2,EPILEPTIC FITS/GIDDINESS
2,2011,0,JAMMU & KASHMIR,2,0,0,0,2,ABORTIONS/CHILD BIRTH
0,2011,13,JAMMU & KASHMIR,13,0,5,5,13,INFLUENCE OF ALCOHOL
1,2011,4,JAMMU & KASHMIR,5,0,0,0,5,FOOD POISIONING/ACCIDENTAL INTAKE OF INSECTICIDES ETC.
2,2011,1,JAMMU & KASHMIR,3,0,0,0,3,SNAKE BITE/ANIMAL BITE
17,2011,9,JAMMU & KASHMIR,40,2,3,5,26,OTHER
1,2011,19,JAMMU & KASHMIR,20,0,0,0,20,OTHER RAILWAY ACCIDENTS
14,2011,36,JAMMU & KASHMIR,46,0,2,2,50,TOTAL DROWNING
19,2011,64,JAMMU & KASHMIR,66,1,3,4,83,TOTAL FALLS
8,2011,15,JAMMU & KASHMIR,30,6,11,17,23,TOTAL FIRE
9,2011,71,JAMMU & KASHMIR,80,0,5,5,80,TOTAL SUDDEN DEATHS
24,2011,21,JAMMU & KASHMIR,69,10,5,15,45,TOTAL POISONING
14,2011,61,JHARKHAND,75,0,5,5,75,ELECTROCUTION
36,2011,7,JHARKHAND,43,2,1,3,43,GAS CYLINDER/STOVE BURST
11,2011,7,JHARKHAND,18,0,0,0,18,FIRE-ARMS
19,2011,61,JHARKHAND,80,0,3,3,80,SUDDEN DEATHS(HEART ATTACKS)
1,2011,22,JHARKHAND,23,0,0,0,23,EPILEPTIC FITS/GIDDINESS
2,2011,0,JHARKHAND,2,0,0,0,2,ABORTIONS/CHILD BIRTH
3,2011,79,JHARKHAND,81,0,5,5,82,INFLUENCE OF ALCOHOL
76,2011,104,JHARKHAND,169,3,9,12,180,FOOD POISIONING/ACCIDENTAL INTAKE OF INSECTICIDES ETC.
15,2011,28,JHARKHAND,43,1,1,2,43,SNAKE BITE/ANIMAL BITE
16,2011,108,JHARKHAND,121,2,2,4,124,OTHER
115,2011,497,JHARKHAND,621,5,7,12,612,OTHER RAILWAY ACCIDENTS
73,2011,314,JHARKHAND,376,9,12,21,387,TOTAL DROWNING
25,2011,161,JHARKHAND,189,1,9,10,186,TOTAL FALLS
232,2011,114,JHARKHAND,344,10,18,28,346,TOTAL FIRE
25,2011,162,JHARKHAND,186,0,8,8,187,TOTAL SUDDEN DEATHS
108,2011,260,JHARKHAND,354,6,12,18,368,TOTAL POISONING
65,2011,340,KARNATAKA,397,3,8,11,405,ELECTROCUTION
290,2011,96,KARNATAKA,355,4,6,10,386,GAS CYLINDER/STOVE BURST
11,2011,20,KARNATAKA,17,4,5,9,31,FIRE-ARMS
91,2011,553,KARNATAKA,617,7,7,14,644,SUDDEN DEATHS(HEART ATTACKS)
33,2011,106,KARNATAKA,114,10,4,14,139,EPILEPTIC FITS/GIDDINESS
12,2011,0,KARNATAKA,12,0,0,0,12,ABORTIONS/CHILD BIRTH
36,2011,268,KARNATAKA,268,10,3,13,304,INFLUENCE OF ALCOHOL
71,2011,190,KARNATAKA,269,4,2,6,261,FOOD POISIONING/ACCIDENTAL INTAKE OF INSECTICIDES ETC.
308,2011,572,KARNATAKA,876,2,3,5,880,SNAKE BITE/ANIMAL BITE
329,2011,1108,KARNATAKA,1370,9,32,41,1437,OTHER
244,2011,1422,KARNATAKA,1648,0,0,0,1666,OTHER RAILWAY ACCIDENTS
500,2011,1593,KARNATAKA,2010,7,24,31,2093,TOTAL DROWNING
66,2011,468,KARNATAKA,498,12,35,47,534,TOTAL FALLS
1176,2011,616,KARNATAKA,1593,27,36,63,1792,TOTAL FIRE
172,2011,927,KARNATAKA,1011,27,14,41,1099,TOTAL SUDDEN DEATHS
768,2011,2018,KARNATAKA,2694,22,39,61,2786,TOTAL POISONING
43,2011,234,KERALA,274,0,0,0,277,ELECTROCUTION
42,2011,10,KERALA,48,0,0,0,52,GAS CYLINDER/STOVE BURST
0,2011,0,KERALA,0,0,0,0,0,FIRE-ARMS
228,2011,1573,KERALA,1797,0,0,0,1801,SUDDEN DEATHS(HEART ATTACKS)
37,2011,109,KERALA,146,0,0,0,146,EPILEPTIC FITS/GIDDINESS
8,2011,0,KERALA,8,0,0,0,8,ABORTIONS/CHILD BIRTH
0,2011,103,KERALA,103,0,0,0,103,INFLUENCE OF ALCOHOL
9,2011,9,KERALA,18,0,0,0,18,FOOD POISIONING/ACCIDENTAL INTAKE OF INSECTICIDES ETC.
19,2011,49,KERALA,68,0,0,0,68,SNAKE BITE/ANIMAL BITE
35,2011,84,KERALA,119,0,0,0,119,OTHER
60,2011,334,KERALA,390,0,2,2,394,OTHER RAILWAY ACCIDENTS
361,2011,1330,KERALA,1667,0,1,1,1691,TOTAL DROWNING
60,2011,638,KERALA,695,0,0,0,698,TOTAL FALLS
191,2011,107,KERALA,289,0,0,0,298,TOTAL FIRE
273,2011,1785,KERALA,2054,0,0,0,2058,TOTAL SUDDEN DEATHS
63,2011,145,KERALA,208,0,0,0,208,TOTAL POISONING
201,2011,1147,MADHYA PRADESH,1352,15,12,27,1348,ELECTROCUTION
152,2011,35,MADHYA PRADESH,187,3,2,5,187,GAS CYLINDER/STOVE BURST
22,2011,157,MADHYA PRADESH,220,4,37,41,179,FIRE-ARMS
122,2011,730,MADHYA PRADESH,852,0,0,0,852,SUDDEN DEATHS(HEART ATTACKS)
40,2011,126,MADHYA PRADESH,164,2,2,4,166,EPILEPTIC FITS/GIDDINESS
195,2011,0,MADHYA PRADESH,196,0,0,0,195,ABORTIONS/CHILD BIRTH
15,2011,471,MADHYA PRADESH,488,0,0,0,486,INFLUENCE OF ALCOHOL
902,2011,1548,MADHYA PRADESH,2410,7,15,22,2450,FOOD POISIONING/ACCIDENTAL INTAKE OF INSECTICIDES ETC.
995,2011,1164,MADHYA PRADESH,2136,2,7,9,2159,SNAKE BITE/ANIMAL BITE
251,2011,324,MADHYA PRADESH,576,0,0,0,575,OTHER
236,2011,1388,MADHYA PRADESH,1615,3,7,10,1624,OTHER RAILWAY ACCIDENTS
1515,2011,3398,MADHYA PRADESH,4909,13,21,34,4913,TOTAL DROWNING
183,2011,745,MADHYA PRADESH,931,1,7,8,928,TOTAL FALLS
2335,2011,1060,MADHYA PRADESH,3383,15,22,37,3395,TOTAL FIRE
372,2011,1327,MADHYA PRADESH,1700,2,2,4,1699,TOTAL SUDDEN DEATHS
2150,2011,3055,MADHYA PRADESH,5143,9,22,31,5205,TOTAL POISONING
181,2011,1088,MAHARASHTRA,1425,33,134,167,1269,ELECTROCUTION
427,2011,114,MAHARASHTRA,560,12,11,23,541,GAS CYLINDER/STOVE BURST
0,2011,0,MAHARASHTRA,2,0,2,2,0,FIRE-ARMS
777,2011,4994,MAHARASHTRA,9926,1710,2453,4163,5771,SUDDEN DEATHS(HEART ATTACKS)
417,2011,1541,MAHARASHTRA,2376,103,317,420,1958,EPILEPTIC FITS/GIDDINESS
345,2011,0,MAHARASHTRA,384,40,0,40,345,ABORTIONS/CHILD BIRTH
18,2011,1167,MAHARASHTRA,1544,1,358,359,1185,INFLUENCE OF ALCOHOL
230,2011,574,MAHARASHTRA,2787,993,1162,2155,804,FOOD POISIONING/ACCIDENTAL INTAKE OF INSECTICIDES ETC.
424,2011,637,MAHARASHTRA,5686,2099,2527,4626,1061,SNAKE BITE/ANIMAL BITE
196,2011,323,MAHARASHTRA,1655,545,603,1148,519,OTHER
552,2011,4429,MAHARASHTRA,8584,487,3128,3615,4981,OTHER RAILWAY ACCIDENTS
1279,2011,3670,MAHARASHTRA,4926,34,53,87,4949,TOTAL DROWNING
354,2011,1881,MAHARASHTRA,3625,283,1119,1402,2235,TOTAL FALLS
4089,2011,1523,MAHARASHTRA,7592,1356,702,2058,5612,TOTAL FIRE
1557,2011,7702,MAHARASHTRA,14230,1854,3128,4982,9259,TOTAL SUDDEN DEATHS
853,2011,1540,MAHARASHTRA,10135,3637,4292,7929,2393,TOTAL POISONING
3,2011,9,MANIPUR,12,0,0,0,12,ELECTROCUTION
0,2011,0,MANIPUR,0,0,0,0,0,GAS CYLINDER/STOVE BURST
0,2011,4,MANIPUR,4,0,0,0,4,FIRE-ARMS
0,2011,2,MANIPUR,2,0,0,0,2,SUDDEN DEATHS(HEART ATTACKS)
0,2011,0,MANIPUR,0,0,0,0,0,EPILEPTIC FITS/GIDDINESS
2,2011,0,MANIPUR,2,0,0,0,2,ABORTIONS/CHILD BIRTH
0,2011,0,MANIPUR,0,0,0,0,0,INFLUENCE OF ALCOHOL
5,2011,0,MANIPUR,5,0,0,0,5,FOOD POISIONING/ACCIDENTAL INTAKE OF INSECTICIDES ETC.
0,2011,0,MANIPUR,0,0,0,0,0,SNAKE BITE/ANIMAL BITE
3,2011,1,MANIPUR,4,0,0,0,4,OTHER
0,2011,0,MANIPUR,0,0,0,0,0,OTHER RAILWAY ACCIDENTS
2,2011,11,MANIPUR,13,0,0,0,13,TOTAL DROWNING
1,2011,3,MANIPUR,4,0,0,0,4,TOTAL FALLS
1,2011,3,MANIPUR,2,0,0,0,4,TOTAL FIRE
2,2011,2,MANIPUR,4,0,0,0,4,TOTAL SUDDEN DEATHS
8,2011,1,MANIPUR,9,0,0,0,9,TOTAL POISONING
0,2011,12,MEGHALAYA,12,0,2,2,12,ELECTROCUTION
0,2011,0,MEGHALAYA,0,0,0,0,0,GAS CYLINDER/STOVE BURST
2,2011,6,MEGHALAYA,8,0,0,0,8,FIRE-ARMS
4,2011,21,MEGHALAYA,25,0,0,0,25,SUDDEN DEATHS(HEART ATTACKS)
1,2011,9,MEGHALAYA,9,0,0,0,10,EPILEPTIC FITS/GIDDINESS
1,2011,0,MEGHALAYA,1,0,0,0,1,ABORTIONS/CHILD BIRTH
0,2011,9,MEGHALAYA,9,0,0,0,9,INFLUENCE OF ALCOHOL
0,2011,0,MEGHALAYA,0,0,0,0,0,FOOD POISIONING/ACCIDENTAL INTAKE OF INSECTICIDES ETC.
0,2011,1,MEGHALAYA,1,0,0,0,1,SNAKE BITE/ANIMAL BITE
0,2011,1,MEGHALAYA,1,0,0,0,1,OTHER
0,2011,0,MEGHALAYA,0,0,0,0,0,OTHER RAILWAY ACCIDENTS
6,2011,43,MEGHALAYA,48,0,0,0,49,TOTAL DROWNING
3,2011,18,MEGHALAYA,22,0,4,4,21,TOTAL FALLS
5,2011,9,MEGHALAYA,10,0,0,0,14,TOTAL FIRE
6,2011,39,MEGHALAYA,44,0,0,0,45,TOTAL SUDDEN DEATHS
0,2011,8,MEGHALAYA,10,0,0,0,8,TOTAL POISONING
1,2011,1,MIZORAM,2,0,0,0,2,ELECTROCUTION
0,2011,0,MIZORAM,0,0,0,0,0,GAS CYLINDER/STOVE BURST
0,2011,2,MIZORAM,2,0,0,0,2,FIRE-ARMS
1,2011,10,MIZORAM,11,0,0,0,11,SUDDEN DEATHS(HEART ATTACKS)
0,2011,0,MIZORAM,0,0,0,0,0,EPILEPTIC FITS/GIDDINESS
1,2011,0,MIZORAM,1,0,0,0,1,ABORTIONS/CHILD BIRTH
0,2011,1,MIZORAM,1,0,0,0,1,INFLUENCE OF ALCOHOL
0,2011,1,MIZORAM,1,0,0,0,1,FOOD POISIONING/ACCIDENTAL INTAKE OF INSECTICIDES ETC.
0,2011,0,MIZORAM,0,0,0,0,0,SNAKE BITE/ANIMAL BITE
3,2011,11,MIZORAM,13,0,0,0,14,OTHER
0,2011,0,MIZORAM,0,0,0,0,0,OTHER RAILWAY ACCIDENTS
6,2011,39,MIZORAM,41,0,0,0,45,TOTAL DROWNING
4,2011,17,MIZORAM,21,0,0,0,21,TOTAL FALLS
2,2011,4,MIZORAM,5,0,0,0,6,TOTAL FIRE
2,2011,11,MIZORAM,13,0,0,0,13,TOTAL SUDDEN DEATHS
3,2011,12,MIZORAM,14,0,0,0,15,TOTAL POISONING
0,2011,2,NAGALAND,2,0,0,0,2,ELECTROCUTION
0,2011,0,NAGALAND,0,0,0,0,0,GAS CYLINDER/STOVE BURST
0,2011,6,NAGALAND,6,0,0,0,6,FIRE-ARMS
0,2011,1,NAGALAND,1,0,0,0,1,SUDDEN DEATHS(HEART ATTACKS)
0,2011,0,NAGALAND,0,0,0,0,0,EPILEPTIC FITS/GIDDINESS
0,2011,0,NAGALAND,0,0,0,0,0,ABORTIONS/CHILD BIRTH
0,2011,0,NAGALAND,0,0,0,0,0,INFLUENCE OF ALCOHOL
0,2011,0,NAGALAND,0,0,0,0,0,FOOD POISIONING/ACCIDENTAL INTAKE OF INSECTICIDES ETC.
0,2011,0,NAGALAND,0,0,0,0,0,SNAKE BITE/ANIMAL BITE
0,2011,0,NAGALAND,0,0,0,0,0,OTHER
0,2011,0,NAGALAND,0,0,0,0,0,OTHER RAILWAY ACCIDENTS
2,2011,7,NAGALAND,8,0,0,0,9,TOTAL DROWNING
0,2011,4,NAGALAND,4,0,0,0,4,TOTAL FALLS
3,2011,2,NAGALAND,2,0,0,0,5,TOTAL FIRE
0,2011,1,NAGALAND,1,0,0,0,1,TOTAL SUDDEN DEATHS
0,2011,2,NAGALAND,1,0,0,0,2,TOTAL POISONING
25,2011,159,ODISHA,184,1,3,4,184,ELECTROCUTION
8,2011,5,ODISHA,13,0,0,0,13,GAS CYLINDER/STOVE BURST
0,2011,4,ODISHA,4,0,0,0,4,FIRE-ARMS
24,2011,63,ODISHA,87,0,0,0,87,SUDDEN DEATHS(HEART ATTACKS)
10,2011,11,ODISHA,21,0,0,0,21,EPILEPTIC FITS/GIDDINESS
8,2011,0,ODISHA,8,0,0,0,8,ABORTIONS/CHILD BIRTH
1,2011,40,ODISHA,41,3,4,7,41,INFLUENCE OF ALCOHOL
130,2011,103,ODISHA,236,3,2,5,233,FOOD POISIONING/ACCIDENTAL INTAKE OF INSECTICIDES ETC.
185,2011,361,ODISHA,548,3,6,9,546,SNAKE BITE/ANIMAL BITE
232,2011,303,ODISHA,535,12,17,29,535,OTHER
44,2011,161,ODISHA,200,5,2,7,205,OTHER RAILWAY ACCIDENTS
136,2011,440,ODISHA,576,6,5,11,576,TOTAL DROWNING
79,2011,316,ODISHA,397,2,19,21,395,TOTAL FALLS
223,2011,187,ODISHA,419,13,18,31,410,TOTAL FIRE
43,2011,114,ODISHA,157,3,4,7,157,TOTAL SUDDEN DEATHS
547,2011,769,ODISHA,1321,18,25,43,1316,TOTAL POISONING
13,2011,258,PUNJAB,271,0,0,0,271,ELECTROCUTION
146,2011,29,PUNJAB,175,0,0,0,175,GAS CYLINDER/STOVE BURST
1,2011,20,PUNJAB,21,0,0,0,21,FIRE-ARMS
42,2011,493,PUNJAB,535,0,0,0,535,SUDDEN DEATHS(HEART ATTACKS)
9,2011,59,PUNJAB,68,0,0,0,68,EPILEPTIC FITS/GIDDINESS
3,2011,0,PUNJAB,3,0,0,0,3,ABORTIONS/CHILD BIRTH
0,2011,253,PUNJAB,253,0,0,0,253,INFLUENCE OF ALCOHOL
104,2011,214,PUNJAB,318,0,0,0,318,FOOD POISIONING/ACCIDENTAL INTAKE OF INSECTICIDES ETC.
13,2011,44,PUNJAB,57,0,0,0,57,SNAKE BITE/ANIMAL BITE
56,2011,189,PUNJAB,245,0,0,0,245,OTHER
103,2011,814,PUNJAB,934,0,0,0,917,OTHER RAILWAY ACCIDENTS
60,2011,444,PUNJAB,501,0,0,0,504,TOTAL DROWNING
14,2011,174,PUNJAB,187,1,1,2,188,TOTAL FALLS
220,2011,167,PUNJAB,387,0,2,2,387,TOTAL FIRE
54,2011,805,PUNJAB,859,0,0,0,859,TOTAL SUDDEN DEATHS
198,2011,536,PUNJAB,733,0,0,0,734,TOTAL POISONING
98,2011,625,RAJASTHAN,720,6,10,16,723,ELECTROCUTION
116,2011,45,RAJASTHAN,160,2,0,2,161,GAS CYLINDER/STOVE BURST
0,2011,6,RAJASTHAN,6,0,0,0,6,FIRE-ARMS
63,2011,428,RAJASTHAN,491,0,0,0,491,SUDDEN DEATHS(HEART ATTACKS)
33,2011,119,RAJASTHAN,153,0,1,1,152,EPILEPTIC FITS/GIDDINESS
23,2011,0,RAJASTHAN,23,0,0,0,23,ABORTIONS/CHILD BIRTH
3,2011,206,RAJASTHAN,206,0,0,0,209,INFLUENCE OF ALCOHOL
288,2011,539,RAJASTHAN,824,1,4,5,827,FOOD POISIONING/ACCIDENTAL INTAKE OF INSECTICIDES ETC.
160,2011,347,RAJASTHAN,506,0,0,0,507,SNAKE BITE/ANIMAL BITE
98,2011,258,RAJASTHAN,347,0,5,5,356,OTHER
42,2011,289,RAJASTHAN,313,0,0,0,331,OTHER RAILWAY ACCIDENTS
460,2011,1191,RAJASTHAN,1556,1,2,3,1651,TOTAL DROWNING
130,2011,615,RAJASTHAN,691,0,5,5,745,TOTAL FALLS
533,2011,317,RAJASTHAN,839,6,10,16,850,TOTAL FIRE
122,2011,753,RAJASTHAN,873,0,1,1,875,TOTAL SUDDEN DEATHS
546,2011,1144,RAJASTHAN,1677,1,9,10,1690,TOTAL POISONING
0,2011,5,SIKKIM,5,0,0,0,5,ELECTROCUTION
0,2011,0,SIKKIM,0,0,0,0,0,GAS CYLINDER/STOVE BURST
0,2011,0,SIKKIM,0,0,0,0,0,FIRE-ARMS
0,2011,0,SIKKIM,0,0,0,0,0,SUDDEN DEATHS(HEART ATTACKS)
0,2011,1,SIKKIM,1,0,0,0,1,EPILEPTIC FITS/GIDDINESS
0,2011,0,SIKKIM,0,0,0,0,0,ABORTIONS/CHILD BIRTH
0,2011,4,SIKKIM,4,0,0,0,4,INFLUENCE OF ALCOHOL
0,2011,0,SIKKIM,0,0,0,0,0,FOOD POISIONING/ACCIDENTAL INTAKE OF INSECTICIDES ETC.
0,2011,0,SIKKIM,0,0,0,0,0,SNAKE BITE/ANIMAL BITE
5,2011,5,SIKKIM,10,0,0,0,10,OTHER
0,2011,0,SIKKIM,0,0,0,0,0,OTHER RAILWAY ACCIDENTS
8,2011,20,SIKKIM,28,0,0,0,28,TOTAL DROWNING
4,2011,36,SIKKIM,40,0,0,0,40,TOTAL FALLS
6,2011,0,SIKKIM,6,0,0,0,6,TOTAL FIRE
0,2011,5,SIKKIM,5,0,0,0,5,TOTAL SUDDEN DEATHS
5,2011,5,SIKKIM,10,0,0,0,10,TOTAL POISONING
55,2011,459,TAMIL NADU,491,0,7,7,514,ELECTROCUTION
481,2011,105,TAMIL NADU,632,9,5,14,586,GAS CYLINDER/STOVE BURST
0,2011,1,TAMIL NADU,1,0,0,0,1,FIRE-ARMS
131,2011,840,TAMIL NADU,1383,18,101,119,971,SUDDEN DEATHS(HEART ATTACKS)
94,2011,539,TAMIL NADU,265,5,7,12,633,EPILEPTIC FITS/GIDDINESS
29,2011,0,TAMIL NADU,29,0,0,0,29,ABORTIONS/CHILD BIRTH
19,2011,131,TAMIL NADU,414,1,19,20,150,INFLUENCE OF ALCOHOL
40,2011,128,TAMIL NADU,231,8,21,29,168,FOOD POISIONING/ACCIDENTAL INTAKE OF INSECTICIDES ETC.
184,2011,351,TAMIL NADU,670,0,0,0,535,SNAKE BITE/ANIMAL BITE
484,2011,983,TAMIL NADU,1388,8,20,28,1467,OTHER
275,2011,1563,TAMIL NADU,1830,5,32,37,1838,OTHER RAILWAY ACCIDENTS
396,2011,1557,TAMIL NADU,1711,1,24,25,1953,TOTAL DROWNING
78,2011,658,TAMIL NADU,672,3,14,17,736,TOTAL FALLS
1617,2011,751,TAMIL NADU,2346,25,33,58,2368,TOTAL FIRE
273,2011,1510,TAMIL NADU,2091,24,127,151,1783,TOTAL SUDDEN DEATHS
889,2011,1785,TAMIL NADU,2682,16,44,60,2674,TOTAL POISONING
1,2011,13,TRIPURA,14,0,0,0,14,ELECTROCUTION
1,2011,0,TRIPURA,1,0,0,0,1,GAS CYLINDER/STOVE BURST
0,2011,0,TRIPURA,0,0,0,0,0,FIRE-ARMS
2,2011,19,TRIPURA,21,0,0,0,21,SUDDEN DEATHS(HEART ATTACKS)
1,2011,0,TRIPURA,1,0,0,0,1,EPILEPTIC FITS/GIDDINESS
0,2011,0,TRIPURA,0,0,0,0,0,ABORTIONS/CHILD BIRTH
0,2011,5,TRIPURA,5,0,0,0,5,INFLUENCE OF ALCOHOL
0,2011,0,TRIPURA,0,0,0,0,0,FOOD POISIONING/ACCIDENTAL INTAKE OF INSECTICIDES ETC.
1,2011,0,TRIPURA,1,0,0,0,1,SNAKE BITE/ANIMAL BITE
0,2011,0,TRIPURA,0,0,0,0,0,OTHER
0,2011,0,TRIPURA,0,0,0,0,0,OTHER RAILWAY ACCIDENTS
14,2011,31,TRIPURA,45,0,0,0,45,TOTAL DROWNING
2,2011,12,TRIPURA,14,0,0,0,14,TOTAL FALLS
8,2011,8,TRIPURA,15,0,0,0,16,TOTAL FIRE
3,2011,24,TRIPURA,27,0,0,0,27,TOTAL SUDDEN DEATHS
1,2011,0,TRIPURA,1,0,0,0,1,TOTAL POISONING
102,2011,575,UTTAR PRADESH,613,9,59,68,677,ELECTROCUTION
77,2011,35,UTTAR PRADESH,108,20,12,32,112,GAS CYLINDER/STOVE BURST
167,2011,545,UTTAR PRADESH,792,46,218,264,712,FIRE-ARMS
61,2011,226,UTTAR PRADESH,287,5,8,13,287,SUDDEN DEATHS(HEART ATTACKS)
18,2011,56,UTTAR PRADESH,76,0,4,4,74,EPILEPTIC FITS/GIDDINESS
77,2011,0,UTTAR PRADESH,80,3,0,3,77,ABORTIONS/CHILD BIRTH
7,2011,186,UTTAR PRADESH,193,0,20,20,193,INFLUENCE OF ALCOHOL
359,2011,528,UTTAR PRADESH,863,13,24,37,887,FOOD POISIONING/ACCIDENTAL INTAKE OF INSECTICIDES ETC.
32,2011,133,UTTAR PRADESH,204,11,36,47,165,SNAKE BITE/ANIMAL BITE
83,2011,186,UTTAR PRADESH,276,18,76,94,269,OTHER
536,2011,2608,UTTAR PRADESH,3938,14,61,75,3144,OTHER RAILWAY ACCIDENTS
191,2011,919,UTTAR PRADESH,1044,16,67,83,1110,TOTAL DROWNING
62,2011,261,UTTAR PRADESH,348,9,46,55,323,TOTAL FALLS
732,2011,436,UTTAR PRADESH,1178,69,116,185,1168,TOTAL FIRE
163,2011,468,UTTAR PRADESH,636,8,32,40,631,TOTAL SUDDEN DEATHS
486,2011,902,UTTAR PRADESH,1396,42,146,188,1388,TOTAL POISONING
7,2011,27,UTTARAKHAND,30,0,6,6,34,ELECTROCUTION
14,2011,3,UTTARAKHAND,23,3,5,8,17,GAS CYLINDER/STOVE BURST
3,2011,11,UTTARAKHAND,9,1,0,1,14,FIRE-ARMS
23,2011,98,UTTARAKHAND,136,4,11,15,121,SUDDEN DEATHS(HEART ATTACKS)
0,2011,2,UTTARAKHAND,2,0,0,0,2,EPILEPTIC FITS/GIDDINESS
14,2011,0,UTTARAKHAND,14,0,0,0,14,ABORTIONS/CHILD BIRTH
1,2011,17,UTTARAKHAND,18,0,0,0,18,INFLUENCE OF ALCOHOL
38,2011,42,UTTARAKHAND,82,4,4,8,80,FOOD POISIONING/ACCIDENTAL INTAKE OF INSECTICIDES ETC.
0,2011,1,UTTARAKHAND,1,0,0,0,1,SNAKE BITE/ANIMAL BITE
47,2011,46,UTTARAKHAND,66,1,2,3,93,OTHER
12,2011,44,UTTARAKHAND,54,0,0,0,56,OTHER RAILWAY ACCIDENTS
69,2011,180,UTTARAKHAND,228,35,53,88,249,TOTAL DROWNING
14,2011,89,UTTARAKHAND,95,3,5,8,103,TOTAL FALLS
32,2011,19,UTTARAKHAND,65,12,11,23,51,TOTAL FIRE
38,2011,117,UTTARAKHAND,170,4,11,15,155,TOTAL SUDDEN DEATHS
85,2011,95,UTTARAKHAND,155,5,6,11,180,TOTAL POISONING
21,2011,135,WEST BENGAL,152,5,16,21,156,ELECTROCUTION
57,2011,10,WEST BENGAL,73,8,10,18,67,GAS CYLINDER/STOVE BURST
1,2011,31,WEST BENGAL,50,4,15,19,32,FIRE-ARMS
237,2011,507,WEST BENGAL,916,61,141,202,744,SUDDEN DEATHS(HEART ATTACKS)
11,2011,19,WEST BENGAL,30,0,0,0,30,EPILEPTIC FITS/GIDDINESS
26,2011,0,WEST BENGAL,43,15,0,15,26,ABORTIONS/CHILD BIRTH
1,2011,41,WEST BENGAL,90,0,36,36,42,INFLUENCE OF ALCOHOL
118,2011,277,WEST BENGAL,404,15,38,53,395,FOOD POISIONING/ACCIDENTAL INTAKE OF INSECTICIDES ETC.
112,2011,118,WEST BENGAL,256,17,27,44,230,SNAKE BITE/ANIMAL BITE
553,2011,752,WEST BENGAL,1437,86,99,185,1305,OTHER
452,2011,1913,WEST BENGAL,2364,7,21,28,2365,OTHER RAILWAY ACCIDENTS
201,2011,514,WEST BENGAL,697,48,102,150,715,TOTAL DROWNING
29,2011,117,WEST BENGAL,140,4,15,19,146,TOTAL FALLS
347,2011,196,WEST BENGAL,539,85,165,250,543,TOTAL FIRE
275,2011,567,WEST BENGAL,1079,76,177,253,842,TOTAL SUDDEN DEATHS
786,2011,1325,WEST BENGAL,2100,119,167,286,2111,TOTAL POISONING
0,2011,4,A & N ISLANDS,4,0,0,0,4,ELECTROCUTION
1,2011,0,A & N ISLANDS,1,0,0,0,1,GAS CYLINDER/STOVE BURST
0,2011,0,A & N ISLANDS,0,0,0,0,0,FIRE-ARMS
0,2011,41,A & N ISLANDS,41,0,0,0,41,SUDDEN DEATHS(HEART ATTACKS)
0,2011,2,A & N ISLANDS,2,0,0,0,2,EPILEPTIC FITS/GIDDINESS
0,2011,0,A & N ISLANDS,0,0,0,0,0,ABORTIONS/CHILD BIRTH
0,2011,0,A & N ISLANDS,0,0,0,0,0,INFLUENCE OF ALCOHOL
0,2011,0,A & N ISLANDS,0,0,0,0,0,FOOD POISIONING/ACCIDENTAL INTAKE OF INSECTICIDES ETC.
0,2011,0,A & N ISLANDS,0,0,0,0,0,SNAKE BITE/ANIMAL BITE
0,2011,0,A & N ISLANDS,0,0,0,0,0,OTHER
0,2011,0,A & N ISLANDS,0,0,0,0,0,OTHER RAILWAY ACCIDENTS
10,2011,37,A & N ISLANDS,45,0,0,0,47,TOTAL DROWNING
0,2011,8,A & N ISLANDS,8,0,0,0,8,TOTAL FALLS
12,2011,2,A & N ISLANDS,14,0,0,0,14,TOTAL FIRE
0,2011,43,A & N ISLANDS,43,0,0,0,43,TOTAL SUDDEN DEATHS
0,2011,0,A & N ISLANDS,0,0,0,0,0,TOTAL POISONING
0,2011,7,CHANDIGARH,7,0,0,0,7,ELECTROCUTION
7,2011,1,CHANDIGARH,8,0,0,0,8,GAS CYLINDER/STOVE BURST
0,2011,0,CHANDIGARH,0,0,0,0,0,FIRE-ARMS
2,2011,50,CHANDIGARH,52,0,0,0,52,SUDDEN DEATHS(HEART ATTACKS)
0,2011,1,CHANDIGARH,1,0,0,0,1,EPILEPTIC FITS/GIDDINESS
0,2011,0,CHANDIGARH,0,0,0,0,0,ABORTIONS/CHILD BIRTH
0,2011,19,CHANDIGARH,19,0,0,0,19,INFLUENCE OF ALCOHOL
1,2011,0,CHANDIGARH,1,0,0,0,1,FOOD POISIONING/ACCIDENTAL INTAKE OF INSECTICIDES ETC.
0,2011,1,CHANDIGARH,1,0,0,0,1,SNAKE BITE/ANIMAL BITE
1,2011,3,CHANDIGARH,4,0,0,0,4,OTHER
0,2011,0,CHANDIGARH,0,0,0,0,0,OTHER RAILWAY ACCIDENTS
1,2011,3,CHANDIGARH,4,0,0,0,4,TOTAL DROWNING
5,2011,15,CHANDIGARH,20,0,0,0,20,TOTAL FALLS
13,2011,2,CHANDIGARH,15,0,0,0,15,TOTAL FIRE
2,2011,70,CHANDIGARH,72,0,0,0,72,TOTAL SUDDEN DEATHS
5,2011,6,CHANDIGARH,11,0,0,0,11,TOTAL POISONING
0,2011,4,D & N HAVELI,4,0,0,0,4,ELECTROCUTION
4,2011,0,D & N HAVELI,4,0,0,0,4,GAS CYLINDER/STOVE BURST
0,2011,0,D & N HAVELI,0,0,0,0,0,FIRE-ARMS
3,2011,6,D & N HAVELI,9,0,0,0,9,SUDDEN DEATHS(HEART ATTACKS)
1,2011,1,D & N HAVELI,2,0,0,0,2,EPILEPTIC FITS/GIDDINESS
0,2011,0,D & N HAVELI,0,0,0,0,0,ABORTIONS/CHILD BIRTH
0,2011,5,D & N HAVELI,5,0,0,0,5,INFLUENCE OF ALCOHOL
0,2011,0,D & N HAVELI,0,0,0,0,0,FOOD POISIONING/ACCIDENTAL INTAKE OF INSECTICIDES ETC.
1,2011,1,D & N HAVELI,2,0,0,0,2,SNAKE BITE/ANIMAL BITE
0,2011,0,D & N HAVELI,0,0,0,0,0,OTHER
0,2011,0,D & N HAVELI,0,0,0,0,0,OTHER RAILWAY ACCIDENTS
1,2011,11,D & N HAVELI,12,0,0,0,12,TOTAL DROWNING
0,2011,6,D & N HAVELI,6,0,0,0,6,TOTAL FALLS
4,2011,1,D & N HAVELI,5,0,0,0,5,TOTAL FIRE
4,2011,12,D & N HAVELI,16,0,0,0,16,TOTAL SUDDEN DEATHS
1,2011,1,D & N HAVELI,2,0,0,0,2,TOTAL POISONING
1,2011,4,DAMAN & DIU,5,0,0,0,5,ELECTROCUTION
3,2011,0,DAMAN & DIU,3,0,0,0,3,GAS CYLINDER/STOVE BURST
0,2011,0,DAMAN & DIU,0,0,0,0,0,FIRE-ARMS
0,2011,6,DAMAN & DIU,6,0,0,0,6,SUDDEN DEATHS(HEART ATTACKS)
0,2011,1,DAMAN & DIU,1,0,0,0,1,EPILEPTIC FITS/GIDDINESS
0,2011,0,DAMAN & DIU,0,0,0,0,0,ABORTIONS/CHILD BIRTH
0,2011,1,DAMAN & DIU,1,0,0,0,1,INFLUENCE OF ALCOHOL
0,2011,1,DAMAN & DIU,1,0,0,0,1,FOOD POISIONING/ACCIDENTAL INTAKE OF INSECTICIDES ETC.
0,2011,0,DAMAN & DIU,0,0,0,0,0,SNAKE BITE/ANIMAL BITE
0,2011,0,DAMAN & DIU,0,0,0,0,0,OTHER
0,2011,0,DAMAN & DIU,0,0,0,0,0,OTHER RAILWAY ACCIDENTS
0,2011,27,DAMAN & DIU,27,0,0,0,27,TOTAL DROWNING
0,2011,10,DAMAN & DIU,10,0,0,0,10,TOTAL FALLS
7,2011,4,DAMAN & DIU,11,0,0,0,11,TOTAL FIRE
0,2011,8,DAMAN & DIU,8,0,0,0,8,TOTAL SUDDEN DEATHS
0,2011,1,DAMAN & DIU,1,0,0,0,1,TOTAL POISONING
20,2011,128,DELHI(UT),161,0,28,28,148,ELECTROCUTION
74,2011,30,DELHI(UT),93,2,14,16,104,GAS CYLINDER/STOVE BURST
6,2011,35,DELHI(UT),55,1,21,22,41,FIRE-ARMS
24,2011,252,DELHI(UT),263,0,0,0,276,SUDDEN DEATHS(HEART ATTACKS)
1,2011,26,DELHI(UT),24,0,0,0,27,EPILEPTIC FITS/GIDDINESS
30,2011,0,DELHI(UT),27,0,0,0,30,ABORTIONS/CHILD BIRTH
0,2011,151,DELHI(UT),143,0,0,0,151,INFLUENCE OF ALCOHOL
16,2011,43,DELHI(UT),69,10,0,10,59,FOOD POISIONING/ACCIDENTAL INTAKE OF INSECTICIDES ETC.
7,2011,11,DELHI(UT),20,0,2,2,18,SNAKE BITE/ANIMAL BITE
48,2011,95,DELHI(UT),137,0,14,14,143,OTHER
102,2011,915,DELHI(UT),1409,37,355,392,1017,OTHER RAILWAY ACCIDENTS
27,2011,169,DELHI(UT),182,0,0,0,196,TOTAL DROWNING
96,2011,379,DELHI(UT),450,5,39,44,475,TOTAL FALLS
159,2011,150,DELHI(UT),296,5,82,87,309,TOTAL FIRE
55,2011,429,DELHI(UT),457,0,0,0,484,TOTAL SUDDEN DEATHS
79,2011,164,DELHI(UT),255,10,22,32,243,TOTAL POISONING
0,2011,0,LAKSHADWEEP,0,0,0,0,0,ELECTROCUTION
1,2011,0,LAKSHADWEEP,1,0,0,0,1,GAS CYLINDER/STOVE BURST
0,2011,0,LAKSHADWEEP,0,0,0,0,0,FIRE-ARMS
0,2011,0,LAKSHADWEEP,0,0,0,0,0,SUDDEN DEATHS(HEART ATTACKS)
0,2011,0,LAKSHADWEEP,0,0,0,0,0,EPILEPTIC FITS/GIDDINESS
0,2011,0,LAKSHADWEEP,0,0,0,0,0,ABORTIONS/CHILD BIRTH
0,2011,0,LAKSHADWEEP,0,0,0,0,0,INFLUENCE OF ALCOHOL
0,2011,0,LAKSHADWEEP,0,0,0,0,0,FOOD POISIONING/ACCIDENTAL INTAKE OF INSECTICIDES ETC.
0,2011,0,LAKSHADWEEP,0,0,0,0,0,SNAKE BITE/ANIMAL BITE
0,2011,0,LAKSHADWEEP,0,0,0,0,0,OTHER
0,2011,0,LAKSHADWEEP,0,0,0,0,0,OTHER RAILWAY ACCIDENTS
0,2011,5,LAKSHADWEEP,5,0,0,0,5,TOTAL DROWNING
0,2011,1,LAKSHADWEEP,1,0,0,0,1,TOTAL FALLS
1,2011,0,LAKSHADWEEP,1,0,0,0,1,TOTAL FIRE
0,2011,0,LAKSHADWEEP,0,0,0,0,0,TOTAL SUDDEN DEATHS
0,2011,0,LAKSHADWEEP,0,0,0,0,0,TOTAL POISONING
5,2011,21,PUDUCHERRY,26,0,0,0,26,ELECTROCUTION
0,2011,0,PUDUCHERRY,0,0,0,0,0,GAS CYLINDER/STOVE BURST
0,2011,0,PUDUCHERRY,0,0,0,0,0,FIRE-ARMS
5,2011,58,PUDUCHERRY,63,0,0,0,63,SUDDEN DEATHS(HEART ATTACKS)
31,2011,251,PUDUCHERRY,282,0,0,0,282,EPILEPTIC FITS/GIDDINESS
0,2011,0,PUDUCHERRY,0,0,0,0,0,ABORTIONS/CHILD BIRTH
2,2011,224,PUDUCHERRY,226,0,0,0,226,INFLUENCE OF ALCOHOL
1,2011,1,PUDUCHERRY,2,0,0,0,2,FOOD POISIONING/ACCIDENTAL INTAKE OF INSECTICIDES ETC.
6,2011,9,PUDUCHERRY,15,0,0,0,15,SNAKE BITE/ANIMAL BITE
1,2011,2,PUDUCHERRY,3,0,0,0,3,OTHER
0,2011,6,PUDUCHERRY,6,0,0,0,6,OTHER RAILWAY ACCIDENTS
8,2011,97,PUDUCHERRY,105,0,0,0,105,TOTAL DROWNING
4,2011,44,PUDUCHERRY,50,0,2,2,48,TOTAL FALLS
35,2011,7,PUDUCHERRY,43,1,1,2,42,TOTAL FIRE
38,2011,533,PUDUCHERRY,571,0,0,0,571,TOTAL SUDDEN DEATHS
8,2011,12,PUDUCHERRY,21,254,241,495,20,TOTAL POISONING
