YEAR,MALE INJURED,CAUSE,FEMALE INJURED,CASES,FEMALE KILLED,INJURED,MALE KILLED,STATE/UT,TOTAL KILLED
2011,2,ELECTROCUTION,1,961,160,3,810,ANDHRA PRADESH,970
2011,10,GAS CYLINDER/STOVE BURST,46,441,337,56,89,ANDHRA PRADESH,426
2011,0,FIRE-ARMS,0,4,3,0,1,ANDHRA PRADESH,4
2011,0,SUDDEN DEATHS(HEART ATTACKS),0,490,122,0,368,ANDHRA PRADESH,490
2011,0,EPILEPTIC FITS/GIDDINESS,0,135,50,0,85,ANDHRA PRADESH,135
2011,0,ABORTIONS/CHILD BIRTH,0,11,11,0,0,ANDHRA PRADESH,11
2011,0,INFLUENCE OF ALCOHOL,0,230,10,0,220,ANDHRA PRADESH,230
2011,5,FOOD POISIONING/ACCIDENTAL INTAKE OF INSECTICIDES ETC.,5,274,84,10,226,ANDHRA PRADESH,310
2011,1,SNAKE BITE/ANIMAL BITE,0,750,269,1,486,ANDHRA PRADESH,755
2011,32,OTHER,18,1549,368,50,1206,ANDHRA PRADESH,1574
2011,0,OTHER RAILWAY ACCIDENTS,0,1362,300,0,1070,ANDHRA PRADESH,1370
2011,21,OTHER,2,797,192,23,624,ANDHRA PRADESH,816
2011,21,DROWNING,9,2751,563,30,2292,ANDHRA PRADESH,2855
2011,15,FALLS,7,1251,195,22,1056,ANDHRA PRADESH,1251
2011,38,FIRE,73,2051,1159,111,906,ANDHRA PRADESH,2065
2011,0,SUDDEN DEATHS,0,866,193,0,673,ANDHRA PRADESH,866
2011,38,POISONING,23,2651,730,61,1989,ANDHRA PRADESH,2719
2011,0,ELECTROCUTION,0,8,3,0,5,ARUNACHAL PRADESH,8
2011,0,GAS CYLINDER/STOVE BURST,0,0,0,0,0,ARUNACHAL PRADESH,0
2011,0,FIRE-ARMS,0,5,0,0,6,ARUNACHAL PRADESH,6
2011,0,SUDDEN DEATHS(HEART ATTACKS),0,5,0,0,5,ARUNACHAL PRADESH,5
2011,0,EPILEPTIC FITS/GIDDINESS,0,2,0,0,2,ARUNACHAL PRADESH,2
2011,0,ABORTIONS/CHILD BIRTH,0,0,0,0,0,ARUNACHAL PRADESH,0
2011,0,INFLUENCE OF ALCOHOL,0,4,0,0,4,ARUNACHAL PRADESH,4
2011,0,FOOD POISIONING/ACCIDENTAL INTAKE OF INSECTICIDES ETC.,0,0,0,0,0,ARUNACHAL PRADESH,0
2011,0,SNAKE BITE/ANIMAL BITE,0,0,0,0,0,ARUNACHAL PRADESH,0
2011,0,OTHER,0,16,3,0,13,ARUNACHAL PRADESH,16
2011,0,OTHER RAILWAY ACCIDENTS,0,0,0,0,0,ARUNACHAL PRADESH,0
2011,0,OTHER,0,21,7,0,17,ARUNACHAL PRADESH,24
2011,0,DROWNING,0,17,4,0,14,ARUNACHAL PRADESH,18
2011,0,FALLS,0,24,3,0,21,ARUNACHAL PRADESH,24
2011,0,FIRE,0,12,3,0,10,ARUNACHAL PRADESH,13
2011,0,SUDDEN DEATHS,0,11,0,0,11,ARUNACHAL PRADESH,11
2011,0,POISONING,0,16,3,0,13,ARUNACHAL PRADESH,16
2011,0,ELECTROCUTION,0,98,9,0,90,ASSAM,99
2011,1,GAS CYLINDER/STOVE BURST,0,17,14,1,2,ASSAM,16
2011,2,FIRE-ARMS,0,16,1,2,18,ASSAM,19
2011,0,SUDDEN DEATHS(HEART ATTACKS),0,47,11,0,36,ASSAM,47
2011,0,EPILEPTIC FITS/GIDDINESS,0,0,0,0,0,ASSAM,0
2011,0,ABORTIONS/CHILD BIRTH,0,10,10,0,0,ASSAM,10
2011,0,INFLUENCE OF ALCOHOL,0,0,0,0,0,ASSAM,0
2011,0,FOOD POISIONING/ACCIDENTAL INTAKE OF INSECTICIDES ETC.,3,32,15,3,14,ASSAM,29
2011,0,SNAKE BITE/ANIMAL BITE,0,7,1,0,6,ASSAM,7
2011,0,OTHER,0,100,45,0,56,ASSAM,101
2011,0,OTHER RAILWAY ACCIDENTS,0,482,54,0,429,ASSAM,483
2011,0,OTHER,3,136,34,3,99,ASSAM,133
2011,0,DROWNING,0,343,91,0,277,ASSAM,368
2011,0,FALLS,0,38,0,0,38,ASSAM,38
2011,1,FIRE,0,166,120,1,45,ASSAM,165
2011,0,SUDDEN DEATHS,0,57,21,0,36,ASSAM,57
2011,0,POISONING,3,140,61,3,77,ASSAM,138
2011,32,ELECTROCUTION,10,195,32,42,181,BIHAR,213
2011,27,GAS CYLINDER/STOVE BURST,32,166,126,59,21,BIHAR,147
2011,7,FIRE-ARMS,2,23,5,9,15,BIHAR,20
2011,1,SUDDEN DEATHS(HEART ATTACKS),1,95,20,2,80,BIHAR,100
2011,8,EPILEPTIC FITS/GIDDINESS,6,41,8,14,21,BIHAR,29
2011,0,ABORTIONS/CHILD BIRTH,0,9,9,0,0,BIHAR,9
2011,22,INFLUENCE OF ALCOHOL,0,136,3,22,126,BIHAR,129
2011,34,FOOD POISIONING/ACCIDENTAL INTAKE OF INSECTICIDES ETC.,30,434,161,64,261,BIHAR,422
2011,3,SNAKE BITE/ANIMAL BITE,0,62,15,3,46,BIHAR,61
2011,53,OTHER,27,304,114,80,178,BIHAR,292
2011,0,OTHER RAILWAY ACCIDENTS,0,1831,290,0,1554,BIHAR,1844
2011,13,OTHER,18,217,66,31,151,BIHAR,217
2011,62,DROWNING,28,503,133,90,390,BIHAR,523
2011,22,FALLS,9,137,15,31,103,BIHAR,118
2011,94,FIRE,75,628,412,169,241,BIHAR,653
2011,31,SUDDEN DEATHS,7,281,40,38,227,BIHAR,267
2011,98,POISONING,62,848,298,160,534,BIHAR,832
2011,1,ELECTROCUTION,0,491,86,1,405,CHHATTISGARH,491
2011,0,GAS CYLINDER/STOVE BURST,0,32,26,0,6,CHHATTISGARH,32
2011,13,FIRE-ARMS,0,109,6,13,90,CHHATTISGARH,96
2011,0,SUDDEN DEATHS(HEART ATTACKS),0,279,50,0,229,CHHATTISGARH,279
2011,0,EPILEPTIC FITS/GIDDINESS,0,77,11,0,66,CHHATTISGARH,77
2011,0,ABORTIONS/CHILD BIRTH,0,13,13,0,0,CHHATTISGARH,13
2011,0,INFLUENCE OF ALCOHOL,0,270,31,0,239,CHHATTISGARH,270
2011,0,FOOD POISIONING/ACCIDENTAL INTAKE OF INSECTICIDES ETC.,0,684,270,0,414,CHHATTISGARH,684
2011,0,SNAKE BITE/ANIMAL BITE,0,823,385,0,438,CHHATTISGARH,823
2011,0,OTHER,0,414,142,0,272,CHHATTISGARH,414
2011,0,OTHER RAILWAY ACCIDENTS,0,584,108,0,500,CHHATTISGARH,608
2011,0,OTHER,0,2087,581,0,1523,CHHATTISGARH,2104
2011,0,DROWNING,1,1685,502,1,1183,CHHATTISGARH,1685
2011,0,FALLS,0,475,91,0,384,CHHATTISGARH,475
2011,0,FIRE,0,993,715,0,278,CHHATTISGARH,993
2011,0,SUDDEN DEATHS,0,639,105,0,534,CHHATTISGARH,639
2011,0,POISONING,0,1923,797,0,1126,CHHATTISGARH,1923
2011,0,ELECTROCUTION,0,21,2,0,19,GOA,21
2011,0,GAS CYLINDER/STOVE BURST,0,5,5,0,0,GOA,5
2011,1,FIRE-ARMS,0,1,0,1,0,GOA,0
2011,0,SUDDEN DEATHS(HEART ATTACKS),0,9,2,0,7,GOA,9
2011,0,EPILEPTIC FITS/GIDDINESS,0,4,0,0,4,GOA,4
2011,0,ABORTIONS/CHILD BIRTH,0,0,0,0,0,GOA,0
2011,0,INFLUENCE OF ALCOHOL,0,6,0,0,6,GOA,6
2011,0,FOOD POISIONING/ACCIDENTAL INTAKE OF INSECTICIDES ETC.,0,5,2,0,3,GOA,5
2011,0,SNAKE BITE/ANIMAL BITE,0,4,0,0,4,GOA,4
2011,0,OTHER,0,2,0,0,2,GOA,2
2011,0,OTHER RAILWAY ACCIDENTS,0,42,1,0,41,GOA,42
2011,1,OTHER,0,63,12,1,56,GOA,68
2011,0,DROWNING,0,148,12,0,136,GOA,148
2011,0,FALLS,0,113,10,0,103,GOA,113
2011,1,FIRE,0,37,24,1,16,GOA,40
2011,0,SUDDEN DEATHS,0,19,2,0,17,GOA,19
2011,0,POISONING,0,11,2,0,9,GOA,11
2011,10,ELECTROCUTION,2,596,125,12,466,GUJARAT,591
2011,8,GAS CYLINDER/STOVE BURST,21,762,559,29,176,GUJARAT,735
2011,0,FIRE-ARMS,0,3,2,0,1,GUJARAT,3
2011,0,SUDDEN DEATHS(HEART ATTACKS),0,1952,211,0,1750,GUJARAT,1961
2011,0,EPILEPTIC FITS/GIDDINESS,0,594,105,0,489,GUJARAT,594
2011,0,ABORTIONS/CHILD BIRTH,0,39,39,0,0,GUJARAT,39
2011,0,INFLUENCE OF ALCOHOL,0,23,2,0,21,GUJARAT,23
2011,79,FOOD POISIONING/ACCIDENTAL INTAKE OF INSECTICIDES ETC.,59,491,126,138,243,GUJARAT,369
2011,25,SNAKE BITE/ANIMAL BITE,13,569,206,38,341,GUJARAT,547
2011,0,OTHER,0,341,155,0,191,GUJARAT,346
2011,0,OTHER RAILWAY ACCIDENTS,0,1070,141,0,929,GUJARAT,1070
2011,9,OTHER,6,1884,351,15,1554,GUJARAT,1905
2011,7,DROWNING,2,1911,356,9,1597,GUJARAT,1953
2011,20,FALLS,7,1268,189,27,1056,GUJARAT,1245
2011,37,FIRE,73,2588,1666,110,848,GUJARAT,2514
2011,0,SUDDEN DEATHS,0,2608,357,0,2260,GUJARAT,2617
2011,104,POISONING,72,1674,556,176,983,GUJARAT,1539
2011,0,ELECTROCUTION,0,346,28,0,318,HARYANA,346
2011,0,GAS CYLINDER/STOVE BURST,0,170,112,0,58,HARYANA,170
2011,0,FIRE-ARMS,0,3,0,0,3,HARYANA,3
2011,0,SUDDEN DEATHS(HEART ATTACKS),0,554,49,0,505,HARYANA,554
2011,0,EPILEPTIC FITS/GIDDINESS,0,72,12,0,60,HARYANA,72
2011,0,ABORTIONS/CHILD BIRTH,0,17,17,0,0,HARYANA,17
2011,0,INFLUENCE OF ALCOHOL,0,309,3,0,306,HARYANA,309
2011,0,FOOD POISIONING/ACCIDENTAL INTAKE OF INSECTICIDES ETC.,0,352,100,0,252,HARYANA,352
2011,0,SNAKE BITE/ANIMAL BITE,0,83,11,0,72,HARYANA,83
2011,0,OTHER,0,252,48,0,204,HARYANA,252
2011,0,OTHER RAILWAY ACCIDENTS,0,1252,124,0,1128,HARYANA,1252
2011,0,OTHER,0,1092,184,0,1054,HARYANA,1238
2011,0,DROWNING,0,574,75,0,501,HARYANA,576
2011,0,FALLS,0,290,31,0,259,HARYANA,290
2011,0,FIRE,0,370,185,0,185,HARYANA,370
2011,0,SUDDEN DEATHS,0,952,81,0,871,HARYANA,952
2011,0,POISONING,0,702,164,0,538,HARYANA,702
2011,1,ELECTROCUTION,0,16,1,1,14,HIMACHAL PRADESH,15
2011,0,GAS CYLINDER/STOVE BURST,1,7,6,1,1,HIMACHAL PRADESH,7
2011,0,FIRE-ARMS,0,4,0,0,4,HIMACHAL PRADESH,4
2011,0,SUDDEN DEATHS(HEART ATTACKS),0,166,13,0,153,HIMACHAL PRADESH,166
2011,0,EPILEPTIC FITS/GIDDINESS,0,2,0,0,2,HIMACHAL PRADESH,2
2011,0,ABORTIONS/CHILD BIRTH,0,4,4,0,0,HIMACHAL PRADESH,4
2011,0,INFLUENCE OF ALCOHOL,0,76,0,0,76,HIMACHAL PRADESH,76
2011,0,FOOD POISIONING/ACCIDENTAL INTAKE OF INSECTICIDES ETC.,0,106,45,0,61,HIMACHAL PRADESH,106
2011,0,SNAKE BITE/ANIMAL BITE,0,17,7,0,10,HIMACHAL PRADESH,17
2011,0,OTHER,0,54,19,0,35,HIMACHAL PRADESH,54
2011,0,OTHER RAILWAY ACCIDENTS,0,27,5,0,22,HIMACHAL PRADESH,27
2011,0,OTHER,0,294,58,0,236,HIMACHAL PRADESH,294
2011,0,DROWNING,0,155,36,0,120,HIMACHAL PRADESH,156
2011,0,FALLS,0,341,43,0,298,HIMACHAL PRADESH,341
2011,0,FIRE,1,69,34,1,38,HIMACHAL PRADESH,72
2011,0,SUDDEN DEATHS,0,248,17,0,231,HIMACHAL PRADESH,248
2011,0,POISONING,0,178,71,0,107,HIMACHAL PRADESH,178
2011,3,ELECTROCUTION,0,17,3,3,14,JAMMU & KASHMIR,17
2011,1,GAS CYLINDER/STOVE BURST,3,8,4,4,1,JAMMU & KASHMIR,5
2011,5,FIRE-ARMS,0,18,1,5,15,JAMMU & KASHMIR,16
2011,0,SUDDEN DEATHS(HEART ATTACKS),0,63,7,0,56,JAMMU & KASHMIR,63
2011,0,EPILEPTIC FITS/GIDDINESS,0,2,0,0,2,JAMMU & KASHMIR,2
2011,0,ABORTIONS/CHILD BIRTH,0,2,2,0,0,JAMMU & KASHMIR,2
2011,5,INFLUENCE OF ALCOHOL,0,13,0,5,13,JAMMU & KASHMIR,13
2011,0,FOOD POISIONING/ACCIDENTAL INTAKE OF INSECTICIDES ETC.,0,5,1,0,4,JAMMU & KASHMIR,5
2011,0,SNAKE BITE/ANIMAL BITE,0,3,2,0,1,JAMMU & KASHMIR,3
2011,3,OTHER,2,40,17,5,9,JAMMU & KASHMIR,26
2011,0,OTHER RAILWAY ACCIDENTS,0,20,1,0,19,JAMMU & KASHMIR,20
2011,5,OTHER,1,129,31,6,93,JAMMU & KASHMIR,124
2011,2,DROWNING,0,46,14,2,36,JAMMU & KASHMIR,50
2011,3,FALLS,1,66,19,4,64,JAMMU & KASHMIR,83
2011,11,FIRE,6,30,8,17,15,JAMMU & KASHMIR,23
2011,5,SUDDEN DEATHS,0,80,9,5,71,JAMMU & KASHMIR,80
2011,5,POISONING,10,69,24,15,21,JAMMU & KASHMIR,45
2011,5,ELECTROCUTION,0,75,14,5,61,JHARKHAND,75
2011,1,GAS CYLINDER/STOVE BURST,2,43,36,3,7,JHARKHAND,43
2011,0,FIRE-ARMS,0,18,11,0,7,JHARKHAND,18
2011,3,SUDDEN DEATHS(HEART ATTACKS),0,80,19,3,61,JHARKHAND,80
2011,0,EPILEPTIC FITS/GIDDINESS,0,23,1,0,22,JHARKHAND,23
2011,0,ABORTIONS/CHILD BIRTH,0,2,2,0,0,JHARKHAND,2
2011,5,INFLUENCE OF ALCOHOL,0,81,3,5,79,JHARKHAND,82
2011,9,FOOD POISIONING/ACCIDENTAL INTAKE OF INSECTICIDES ETC.,3,169,76,12,104,JHARKHAND,180
2011,1,SNAKE BITE/ANIMAL BITE,1,43,15,2,28,JHARKHAND,43
2011,2,OTHER,2,121,16,4,108,JHARKHAND,124
2011,7,OTHER RAILWAY ACCIDENTS,5,621,115,12,497,JHARKHAND,612
2011,12,OTHER,8,412,88,20,331,JHARKHAND,419
2011,12,DROWNING,9,376,73,21,314,JHARKHAND,387
2011,9,FALLS,1,189,25,10,161,JHARKHAND,186
2011,18,FIRE,10,344,232,28,114,JHARKHAND,346
2011,8,SUDDEN DEATHS,0,186,25,8,162,JHARKHAND,187
2011,12,POISONING,6,354,108,18,260,JHARKHAND,368
2011,8,ELECTROCUTION,3,397,65,11,340,KARNATAKA,405
2011,6,GAS CYLINDER/STOVE BURST,4,355,290,10,96,KARNATAKA,386
2011,5,FIRE-ARMS,4,17,11,9,20,KARNATAKA,31
2011,7,SUDDEN DEATHS(HEART ATTACKS),7,617,91,14,553,KARNATAKA,644
2011,4,EPILEPTIC FITS/GIDDINESS,10,114,33,14,106,KARNATAKA,139
2011,0,ABORTIONS/CHILD BIRTH,0,12,12,0,0,KARNATAKA,12
2011,3,INFLUENCE OF ALCOHOL,10,268,36,13,268,KARNATAKA,304
2011,2,FOOD POISIONING/ACCIDENTAL INTAKE OF INSECTICIDES ETC.,4,269,71,6,190,KARNATAKA,261
2011,3,SNAKE BITE/ANIMAL BITE,2,876,308,5,572,KARNATAKA,880
2011,32,OTHER,9,1370,329,41,1108,KARNATAKA,1437
2011,0,OTHER RAILWAY ACCIDENTS,0,1648,244,0,1422,KARNATAKA,1666
2011,102,OTHER,105,1250,352,207,1322,KARNATAKA,1674
2011,24,DROWNING,7,2010,500,31,1593,KARNATAKA,2093
2011,35,FALLS,12,498,66,47,468,KARNATAKA,534
2011,36,FIRE,27,1593,1176,63,616,KARNATAKA,1792
2011,14,SUDDEN DEATHS,27,1011,172,41,927,KARNATAKA,1099
2011,39,POISONING,22,2694,768,61,2018,KARNATAKA,2786
2011,0,ELECTROCUTION,0,274,43,0,234,KERALA,277
2011,0,GAS CYLINDER/STOVE BURST,0,48,42,0,10,KERALA,52
2011,0,FIRE-ARMS,0,0,0,0,0,KERALA,0
2011,0,SUDDEN DEATHS(HEART ATTACKS),0,1797,228,0,1573,KERALA,1801
2011,0,EPILEPTIC FITS/GIDDINESS,0,146,37,0,109,KERALA,146
2011,0,ABORTIONS/CHILD BIRTH,0,8,8,0,0,KERALA,8
2011,0,INFLUENCE OF ALCOHOL,0,103,0,0,103,KERALA,103
2011,0,FOOD POISIONING/ACCIDENTAL INTAKE OF INSECTICIDES ETC.,0,18,9,0,9,KERALA,18
2011,0,SNAKE BITE/ANIMAL BITE,0,68,19,0,49,KERALA,68
2011,0,OTHER,0,119,35,0,84,KERALA,119
2011,2,OTHER RAILWAY ACCIDENTS,0,390,60,2,334,KERALA,394
2011,0,OTHER,2,510,113,2,397,KERALA,510
2011,1,DROWNING,0,1667,361,1,1330,KERALA,1691
2011,0,FALLS,0,695,60,0,638,KERALA,698
2011,0,FIRE,0,289,191,0,107,KERALA,298
2011,0,SUDDEN DEATHS,0,2054,273,0,1785,KERALA,2058
2011,0,POISONING,0,208,63,0,145,KERALA,208
2011,12,ELECTROCUTION,15,1352,201,27,1147,MADHYA PRADESH,1348
2011,2,GAS CYLINDER/STOVE BURST,3,187,152,5,35,MADHYA PRADESH,187
2011,37,FIRE-ARMS,4,220,22,41,157,MADHYA PRADESH,179
2011,0,SUDDEN DEATHS(HEART ATTACKS),0,852,122,0,730,MADHYA PRADESH,852
2011,2,EPILEPTIC FITS/GIDDINESS,2,164,40,4,126,MADHYA PRADESH,166
2011,0,ABORTIONS/CHILD BIRTH,0,196,195,0,0,MADHYA PRADESH,195
2011,0,INFLUENCE OF ALCOHOL,0,488,15,0,471,MADHYA PRADESH,486
2011,15,FOOD POISIONING/ACCIDENTAL INTAKE OF INSECTICIDES ETC.,7,2410,902,22,1548,MADHYA PRADESH,2450
2011,7,SNAKE BITE/ANIMAL BITE,2,2136,995,9,1164,MADHYA PRADESH,2159
2011,0,OTHER,0,576,251,0,324,MADHYA PRADESH,575
2011,7,OTHER RAILWAY ACCIDENTS,3,1615,236,10,1388,MADHYA PRADESH,1624
2011,128,OTHER,12,4049,1051,140,3011,MADHYA PRADESH,4062
2011,21,DROWNING,13,4909,1515,34,3398,MADHYA PRADESH,4913
2011,7,FALLS,1,931,183,8,745,MADHYA PRADESH,928
2011,22,FIRE,15,3383,2335,37,1060,MADHYA PRADESH,3395
2011,2,SUDDEN DEATHS,2,1700,372,4,1327,MADHYA PRADESH,1699
2011,22,POISONING,9,5143,2150,31,3055,MADHYA PRADESH,5205
2011,134,ELECTROCUTION,33,1425,181,167,1088,MAHARASHTRA,1269
2011,11,GAS CYLINDER/STOVE BURST,12,560,427,23,114,MAHARASHTRA,541
2011,2,FIRE-ARMS,0,2,0,2,0,MAHARASHTRA,0
2011,2453,SUDDEN DEATHS(HEART ATTACKS),1710,9926,777,4163,4994,MAHARASHTRA,5771
2011,317,EPILEPTIC FITS/GIDDINESS,103,2376,417,420,1541,MAHARASHTRA,1958
2011,0,ABORTIONS/CHILD BIRTH,40,384,345,40,0,MAHARASHTRA,345
2011,358,INFLUENCE OF ALCOHOL,1,1544,18,359,1167,MAHARASHTRA,1185
2011,1162,FOOD POISIONING/ACCIDENTAL INTAKE OF INSECTICIDES ETC.,993,2787,230,2155,574,MAHARASHTRA,804
2011,2527,SNAKE BITE/ANIMAL BITE,2099,5686,424,4626,637,MAHARASHTRA,1061
2011,603,OTHER,545,1655,196,1148,323,MAHARASHTRA,519
2011,3128,OTHER RAILWAY ACCIDENTS,487,8584,552,3615,4429,MAHARASHTRA,4981
2011,2847,OTHER,1337,18844,3399,4184,11051,MAHARASHTRA,14450
2011,53,DROWNING,34,4926,1279,87,3670,MAHARASHTRA,4949
2011,1119,FALLS,283,3625,354,1402,1881,MAHARASHTRA,2235
2011,702,FIRE,1356,7592,4089,2058,1523,MAHARASHTRA,5612
2011,3128,SUDDEN DEATHS,1854,14230,1557,4982,7702,MAHARASHTRA,9259
2011,4292,POISONING,3637,10135,853,7929,1540,MAHARASHTRA,2393
2011,0,ELECTROCUTION,0,12,3,0,9,MANIPUR,12
2011,0,GAS CYLINDER/STOVE BURST,0,0,0,0,0,MANIPUR,0
2011,0,FIRE-ARMS,0,4,0,0,4,MANIPUR,4
2011,0,SUDDEN DEATHS(HEART ATTACKS),0,2,0,0,2,MANIPUR,2
2011,0,EPILEPTIC FITS/GIDDINESS,0,0,0,0,0,MANIPUR,0
2011,0,ABORTIONS/CHILD BIRTH,0,2,2,0,0,MANIPUR,2
2011,0,INFLUENCE OF ALCOHOL,0,0,0,0,0,MANIPUR,0
2011,0,FOOD POISIONING/ACCIDENTAL INTAKE OF INSECTICIDES ETC.,0,5,5,0,0,MANIPUR,5
2011,0,SNAKE BITE/ANIMAL BITE,0,0,0,0,0,MANIPUR,0
2011,0,OTHER,0,4,3,0,1,MANIPUR,4
2011,0,OTHER RAILWAY ACCIDENTS,0,0,0,0,0,MANIPUR,0
2011,0,OTHER,0,46,10,0,36,MANIPUR,46
2011,0,DROWNING,0,13,2,0,11,MANIPUR,13
2011,0,FALLS,0,4,1,0,3,MANIPUR,4
2011,0,FIRE,0,2,1,0,3,MANIPUR,4
2011,0,SUDDEN DEATHS,0,4,2,0,2,MANIPUR,4
2011,0,POISONING,0,9,8,0,1,MANIPUR,9
2011,2,ELECTROCUTION,0,12,0,2,12,MEGHALAYA,12
2011,0,GAS CYLINDER/STOVE BURST,0,0,0,0,0,MEGHALAYA,0
2011,0,FIRE-ARMS,0,8,2,0,6,MEGHALAYA,8
2011,0,SUDDEN DEATHS(HEART ATTACKS),0,25,4,0,21,MEGHALAYA,25
2011,0,EPILEPTIC FITS/GIDDINESS,0,9,1,0,9,MEGHALAYA,10
2011,0,ABORTIONS/CHILD BIRTH,0,1,1,0,0,MEGHALAYA,1
2011,0,INFLUENCE OF ALCOHOL,0,9,0,0,9,MEGHALAYA,9
2011,0,FOOD POISIONING/ACCIDENTAL INTAKE OF INSECTICIDES ETC.,0,0,0,0,0,MEGHALAYA,0
2011,0,SNAKE BITE/ANIMAL BITE,0,1,0,0,1,MEGHALAYA,1
2011,0,OTHER,0,1,0,0,1,MEGHALAYA,1
2011,0,OTHER RAILWAY ACCIDENTS,0,0,0,0,0,MEGHALAYA,0
2011,1,OTHER,0,58,15,1,45,MEGHALAYA,60
2011,0,DROWNING,0,48,6,0,43,MEGHALAYA,49
2011,4,FALLS,0,22,3,4,18,MEGHALAYA,21
2011,0,FIRE,0,10,5,0,9,MEGHALAYA,14
2011,0,SUDDEN DEATHS,0,44,6,0,39,MEGHALAYA,45
2011,0,POISONING,0,10,0,0,8,MEGHALAYA,8
2011,0,ELECTROCUTION,0,2,1,0,1,MIZORAM,2
2011,0,GAS CYLINDER/STOVE BURST,0,0,0,0,0,MIZORAM,0
2011,0,FIRE-ARMS,0,2,0,0,2,MIZORAM,2
2011,0,SUDDEN DEATHS(HEART ATTACKS),0,11,1,0,10,MIZORAM,11
2011,0,EPILEPTIC FITS/GIDDINESS,0,0,0,0,0,MIZORAM,0
2011,0,ABORTIONS/CHILD BIRTH,0,1,1,0,0,MIZORAM,1
2011,0,INFLUENCE OF ALCOHOL,0,1,0,0,1,MIZORAM,1
2011,0,FOOD POISIONING/ACCIDENTAL INTAKE OF INSECTICIDES ETC.,0,1,0,0,1,MIZORAM,1
2011,0,SNAKE BITE/ANIMAL BITE,0,0,0,0,0,MIZORAM,0
2011,0,OTHER,0,13,3,0,11,MIZORAM,14
2011,0,OTHER RAILWAY ACCIDENTS,0,0,0,0,0,MIZORAM,0
2011,0,OTHER,0,53,10,0,43,MIZORAM,53
2011,0,DROWNING,0,41,6,0,39,MIZORAM,45
2011,0,FALLS,0,21,4,0,17,MIZORAM,21
2011,0,FIRE,0,5,2,0,4,MIZORAM,6
2011,0,SUDDEN DEATHS,0,13,2,0,11,MIZORAM,13
2011,0,POISONING,0,14,3,0,12,MIZORAM,15
2011,0,ELECTROCUTION,0,2,0,0,2,NAGALAND,2
2011,0,GAS CYLINDER/STOVE BURST,0,0,0,0,0,NAGALAND,0
2011,0,FIRE-ARMS,0,6,0,0,6,NAGALAND,6
2011,0,SUDDEN DEATHS(HEART ATTACKS),0,1,0,0,1,NAGALAND,1
2011,0,EPILEPTIC FITS/GIDDINESS,0,0,0,0,0,NAGALAND,0
2011,0,ABORTIONS/CHILD BIRTH,0,0,0,0,0,NAGALAND,0
2011,0,INFLUENCE OF ALCOHOL,0,0,0,0,0,NAGALAND,0
2011,0,FOOD POISIONING/ACCIDENTAL INTAKE OF INSECTICIDES ETC.,0,0,0,0,0,NAGALAND,0
2011,0,SNAKE BITE/ANIMAL BITE,0,0,0,0,0,NAGALAND,0
2011,0,OTHER,0,0,0,0,0,NAGALAND,0
2011,0,OTHER RAILWAY ACCIDENTS,0,0,0,0,0,NAGALAND,0
2011,0,OTHER,0,0,0,0,0,NAGALAND,0
2011,0,DROWNING,0,8,2,0,7,NAGALAND,9
2011,0,FALLS,0,4,0,0,4,NAGALAND,4
2011,0,FIRE,0,2,3,0,2,NAGALAND,5
2011,0,SUDDEN DEATHS,0,1,0,0,1,NAGALAND,1
2011,0,POISONING,0,1,0,0,2,NAGALAND,2
2011,3,ELECTROCUTION,1,184,25,4,159,ODISHA,184
2011,0,GAS CYLINDER/STOVE BURST,0,13,8,0,5,ODISHA,13
2011,0,FIRE-ARMS,0,4,0,0,4,ODISHA,4
2011,0,SUDDEN DEATHS(HEART ATTACKS),0,87,24,0,63,ODISHA,87
2011,0,EPILEPTIC FITS/GIDDINESS,0,21,10,0,11,ODISHA,21
2011,0,ABORTIONS/CHILD BIRTH,0,8,8,0,0,ODISHA,8
2011,4,INFLUENCE OF ALCOHOL,3,41,1,7,40,ODISHA,41
2011,2,FOOD POISIONING/ACCIDENTAL INTAKE OF INSECTICIDES ETC.,3,236,130,5,103,ODISHA,233
2011,6,SNAKE BITE/ANIMAL BITE,3,548,185,9,361,ODISHA,546
2011,17,OTHER,12,535,232,29,303,ODISHA,535
2011,2,OTHER RAILWAY ACCIDENTS,5,200,44,7,161,ODISHA,205
2011,27,OTHER,19,1410,420,46,994,ODISHA,1414
2011,5,DROWNING,6,576,136,11,440,ODISHA,576
2011,19,FALLS,2,397,79,21,316,ODISHA,395
2011,18,FIRE,13,419,223,31,187,ODISHA,410
2011,4,SUDDEN DEATHS,3,157,43,7,114,ODISHA,157
2011,25,POISONING,18,1321,547,43,769,ODISHA,1316
2011,0,ELECTROCUTION,0,271,13,0,258,PUNJAB,271
2011,0,GAS CYLINDER/STOVE BURST,0,175,146,0,29,PUNJAB,175
2011,0,FIRE-ARMS,0,21,1,0,20,PUNJAB,21
2011,0,SUDDEN DEATHS(HEART ATTACKS),0,535,42,0,493,PUNJAB,535
2011,0,EPILEPTIC FITS/GIDDINESS,0,68,9,0,59,PUNJAB,68
2011,0,ABORTIONS/CHILD BIRTH,0,3,3,0,0,PUNJAB,3
2011,0,INFLUENCE OF ALCOHOL,0,253,0,0,253,PUNJAB,253
2011,0,FOOD POISIONING/ACCIDENTAL INTAKE OF INSECTICIDES ETC.,0,318,104,0,214,PUNJAB,318
2011,0,SNAKE BITE/ANIMAL BITE,0,57,13,0,44,PUNJAB,57
2011,0,OTHER,0,245,56,0,189,PUNJAB,245
2011,0,OTHER RAILWAY ACCIDENTS,0,934,103,0,814,PUNJAB,917
2011,0,OTHER,0,410,50,0,362,PUNJAB,412
2011,0,DROWNING,0,501,60,0,444,PUNJAB,504
2011,1,FALLS,1,187,14,2,174,PUNJAB,188
2011,2,FIRE,0,387,220,2,167,PUNJAB,387
2011,0,SUDDEN DEATHS,0,859,54,0,805,PUNJAB,859
2011,0,POISONING,0,733,198,0,536,PUNJAB,734
2011,10,ELECTROCUTION,6,720,98,16,625,RAJASTHAN,723
2011,0,GAS CYLINDER/STOVE BURST,2,160,116,2,45,RAJASTHAN,161
2011,0,FIRE-ARMS,0,6,0,0,6,RAJASTHAN,6
2011,0,SUDDEN DEATHS(HEART ATTACKS),0,491,63,0,428,RAJASTHAN,491
2011,1,EPILEPTIC FITS/GIDDINESS,0,153,33,1,119,RAJASTHAN,152
2011,0,ABORTIONS/CHILD BIRTH,0,23,23,0,0,RAJASTHAN,23
2011,0,INFLUENCE OF ALCOHOL,0,206,3,0,206,RAJASTHAN,209
2011,4,FOOD POISIONING/ACCIDENTAL INTAKE OF INSECTICIDES ETC.,1,824,288,5,539,RAJASTHAN,827
2011,0,SNAKE BITE/ANIMAL BITE,0,506,160,0,347,RAJASTHAN,507
2011,5,OTHER,0,347,98,5,258,RAJASTHAN,356
2011,0,OTHER RAILWAY ACCIDENTS,0,313,42,0,289,RAJASTHAN,331
2011,10,OTHER,4,2464,553,14,1936,RAJASTHAN,2489
2011,2,DROWNING,1,1556,460,3,1191,RAJASTHAN,1651
2011,5,FALLS,0,691,130,5,615,RAJASTHAN,745
2011,10,FIRE,6,839,533,16,317,RAJASTHAN,850
2011,1,SUDDEN DEATHS,0,873,122,1,753,RAJASTHAN,875
2011,9,POISONING,1,1677,546,10,1144,RAJASTHAN,1690
2011,0,ELECTROCUTION,0,5,0,0,5,SIKKIM,5
2011,0,GAS CYLINDER/STOVE BURST,0,0,0,0,0,SIKKIM,0
2011,0,FIRE-ARMS,0,0,0,0,0,SIKKIM,0
2011,0,SUDDEN DEATHS(HEART ATTACKS),0,0,0,0,0,SIKKIM,0
2011,0,EPILEPTIC FITS/GIDDINESS,0,1,0,0,1,SIKKIM,1
2011,0,ABORTIONS/CHILD BIRTH,0,0,0,0,0,SIKKIM,0
2011,0,INFLUENCE OF ALCOHOL,0,4,0,0,4,SIKKIM,4
2011,0,FOOD POISIONING/ACCIDENTAL INTAKE OF INSECTICIDES ETC.,0,0,0,0,0,SIKKIM,0
2011,0,SNAKE BITE/ANIMAL BITE,0,0,0,0,0,SIKKIM,0
2011,0,OTHER,0,10,5,0,5,SIKKIM,10
2011,0,OTHER RAILWAY ACCIDENTS,0,0,0,0,0,SIKKIM,0
2011,0,OTHER,0,0,0,0,0,SIKKIM,0
2011,0,DROWNING,0,28,8,0,20,SIKKIM,28
2011,0,FALLS,0,40,4,0,36,SIKKIM,40
2011,0,FIRE,0,6,6,0,0,SIKKIM,6
2011,0,SUDDEN DEATHS,0,5,0,0,5,SIKKIM,5
2011,0,POISONING,0,10,5,0,5,SIKKIM,10
2011,7,ELECTROCUTION,0,491,55,7,459,TAMIL NADU,514
2011,5,GAS CYLINDER/STOVE BURST,9,632,481,14,105,TAMIL NADU,586
2011,0,FIRE-ARMS,0,1,0,0,1,TAMIL NADU,1
2011,101,SUDDEN DEATHS(HEART ATTACKS),18,1383,131,119,840,TAMIL NADU,971
2011,7,EPILEPTIC FITS/GIDDINESS,5,265,94,12,539,TAMIL NADU,633
2011,0,ABORTIONS/CHILD BIRTH,0,29,29,0,0,TAMIL NADU,29
2011,19,INFLUENCE OF ALCOHOL,1,414,19,20,131,TAMIL NADU,150
2011,21,FOOD POISIONING/ACCIDENTAL INTAKE OF INSECTICIDES ETC.,8,231,40,29,128,TAMIL NADU,168
2011,0,SNAKE BITE/ANIMAL BITE,0,670,184,0,351,TAMIL NADU,535
2011,20,OTHER,8,1388,484,28,983,TAMIL NADU,1467
2011,32,OTHER RAILWAY ACCIDENTS,5,1830,275,37,1563,TAMIL NADU,1838
2011,47,OTHER,2,2660,844,49,1890,TAMIL NADU,2734
2011,24,DROWNING,1,1711,396,25,1557,TAMIL NADU,1953
2011,14,FALLS,3,672,78,17,658,TAMIL NADU,736
2011,33,FIRE,25,2346,1617,58,751,TAMIL NADU,2368
2011,127,SUDDEN DEATHS,24,2091,273,151,1510,TAMIL NADU,1783
2011,44,POISONING,16,2682,889,60,1785,TAMIL NADU,2674
2011,0,ELECTROCUTION,0,14,1,0,13,TRIPURA,14
2011,0,GAS CYLINDER/STOVE BURST,0,1,1,0,0,TRIPURA,1
2011,0,FIRE-ARMS,0,0,0,0,0,TRIPURA,0
2011,0,SUDDEN DEATHS(HEART ATTACKS),0,21,2,0,19,TRIPURA,21
2011,0,EPILEPTIC FITS/GIDDINESS,0,1,1,0,0,TRIPURA,1
2011,0,ABORTIONS/CHILD BIRTH,0,0,0,0,0,TRIPURA,0
2011,0,INFLUENCE OF ALCOHOL,0,5,0,0,5,TRIPURA,5
2011,0,FOOD POISIONING/ACCIDENTAL INTAKE OF INSECTICIDES ETC.,0,0,0,0,0,TRIPURA,0
2011,0,SNAKE BITE/ANIMAL BITE,0,1,1,0,0,TRIPURA,1
2011,0,OTHER,0,0,0,0,0,TRIPURA,0
2011,0,OTHER RAILWAY ACCIDENTS,0,0,0,0,0,TRIPURA,0
2011,0,OTHER,0,129,30,0,99,TRIPURA,129
2011,0,DROWNING,0,45,14,0,31,TRIPURA,45
2011,0,FALLS,0,14,2,0,12,TRIPURA,14
2011,0,FIRE,0,15,8,0,8,TRIPURA,16
2011,0,SUDDEN DEATHS,0,27,3,0,24,TRIPURA,27
2011,0,POISONING,0,1,1,0,0,TRIPURA,1
2011,59,ELECTROCUTION,9,613,102,68,575,UTTAR PRADESH,677
2011,12,GAS CYLINDER/STOVE BURST,20,108,77,32,35,UTTAR PRADESH,112
2011,218,FIRE-ARMS,46,792,167,264,545,UTTAR PRADESH,712
2011,8,SUDDEN DEATHS(HEART ATTACKS),5,287,61,13,226,UTTAR PRADESH,287
2011,4,EPILEPTIC FITS/GIDDINESS,0,76,18,4,56,UTTAR PRADESH,74
2011,0,ABORTIONS/CHILD BIRTH,3,80,77,3,0,UTTAR PRADESH,77
2011,20,INFLUENCE OF ALCOHOL,0,193,7,20,186,UTTAR PRADESH,193
2011,24,FOOD POISIONING/ACCIDENTAL INTAKE OF INSECTICIDES ETC.,13,863,359,37,528,UTTAR PRADESH,887
2011,36,SNAKE BITE/ANIMAL BITE,11,204,32,47,133,UTTAR PRADESH,165
2011,76,OTHER,18,276,83,94,186,UTTAR PRADESH,269
2011,61,OTHER RAILWAY ACCIDENTS,14,3938,536,75,2608,UTTAR PRADESH,3144
2011,88,OTHER,32,1351,332,120,1042,UTTAR PRADESH,1374
2011,67,DROWNING,16,1044,191,83,919,UTTAR PRADESH,1110
2011,46,FALLS,9,348,62,55,261,UTTAR PRADESH,323
2011,116,FIRE,69,1178,732,185,436,UTTAR PRADESH,1168
2011,32,SUDDEN DEATHS,8,636,163,40,468,UTTAR PRADESH,631
2011,146,POISONING,42,1396,486,188,902,UTTAR PRADESH,1388
2011,6,ELECTROCUTION,0,30,7,6,27,UTTARAKHAND,34
2011,5,GAS CYLINDER/STOVE BURST,3,23,14,8,3,UTTARAKHAND,17
2011,0,FIRE-ARMS,1,9,3,1,11,UTTARAKHAND,14
2011,11,SUDDEN DEATHS(HEART ATTACKS),4,136,23,15,98,UTTARAKHAND,121
2011,0,EPILEPTIC FITS/GIDDINESS,0,2,0,0,2,UTTARAKHAND,2
2011,0,ABORTIONS/CHILD BIRTH,0,14,14,0,0,UTTARAKHAND,14
2011,0,INFLUENCE OF ALCOHOL,0,18,1,0,17,UTTARAKHAND,18
2011,4,FOOD POISIONING/ACCIDENTAL INTAKE OF INSECTICIDES ETC.,4,82,38,8,42,UTTARAKHAND,80
2011,0,SNAKE BITE/ANIMAL BITE,0,1,0,0,1,UTTARAKHAND,1
2011,2,OTHER,1,66,47,3,46,UTTARAKHAND,93
2011,0,OTHER RAILWAY ACCIDENTS,0,54,12,0,44,UTTARAKHAND,56
2011,0,OTHER,0,146,31,0,139,UTTARAKHAND,170
2011,53,DROWNING,35,228,69,88,180,UTTARAKHAND,249
2011,5,FALLS,3,95,14,8,89,UTTARAKHAND,103
2011,11,FIRE,12,65,32,23,19,UTTARAKHAND,51
2011,11,SUDDEN DEATHS,4,170,38,15,117,UTTARAKHAND,155
2011,6,POISONING,5,155,85,11,95,UTTARAKHAND,180
2011,16,ELECTROCUTION,5,152,21,21,135,WEST BENGAL,156
2011,10,GAS CYLINDER/STOVE BURST,8,73,57,18,10,WEST BENGAL,67
2011,15,FIRE-ARMS,4,50,1,19,31,WEST BENGAL,32
2011,141,SUDDEN DEATHS(HEART ATTACKS),61,916,237,202,507,WEST BENGAL,744
2011,0,EPILEPTIC FITS/GIDDINESS,0,30,11,0,19,WEST BENGAL,30
2011,0,ABORTIONS/CHILD BIRTH,15,43,26,15,0,WEST BENGAL,26
2011,36,INFLUENCE OF ALCOHOL,0,90,1,36,41,WEST BENGAL,42
2011,38,FOOD POISIONING/ACCIDENTAL INTAKE OF INSECTICIDES ETC.,15,404,118,53,277,WEST BENGAL,395
2011,27,SNAKE BITE/ANIMAL BITE,17,256,112,44,118,WEST BENGAL,230
2011,99,OTHER,86,1437,553,185,752,WEST BENGAL,1305
2011,21,OTHER RAILWAY ACCIDENTS,7,2364,452,28,1913,WEST BENGAL,2365
2011,51,OTHER,20,892,484,71,657,WEST BENGAL,1141
2011,102,DROWNING,48,697,201,150,514,WEST BENGAL,715
2011,15,FALLS,4,140,29,19,117,WEST BENGAL,146
2011,165,FIRE,85,539,347,250,196,WEST BENGAL,543
2011,177,SUDDEN DEATHS,76,1079,275,253,567,WEST BENGAL,842
2011,167,POISONING,119,2100,786,286,1325,WEST BENGAL,2111
2011,0,ELECTROCUTION,0,4,0,0,4,A & N ISLANDS,4
2011,0,GAS CYLINDER/STOVE BURST,0,1,1,0,0,A & N ISLANDS,1
2011,0,FIRE-ARMS,0,0,0,0,0,A & N ISLANDS,0
2011,0,SUDDEN DEATHS(HEART ATTACKS),0,41,0,0,41,A & N ISLANDS,41
2011,0,EPILEPTIC FITS/GIDDINESS,0,2,0,0,2,A & N ISLANDS,2
2011,0,ABORTIONS/CHILD BIRTH,0,0,0,0,0,A & N ISLANDS,0
2011,0,INFLUENCE OF ALCOHOL,0,0,0,0,0,A & N ISLANDS,0
2011,0,FOOD POISIONING/ACCIDENTAL INTAKE OF INSECTICIDES ETC.,0,0,0,0,0,A & N ISLANDS,0
2011,0,SNAKE BITE/ANIMAL BITE,0,0,0,0,0,A & N ISLANDS,0
2011,0,OTHER,0,0,0,0,0,A & N ISLANDS,0
2011,0,OTHER RAILWAY ACCIDENTS,0,0,0,0,0,A & N ISLANDS,0
2011,0,OTHER,0,62,7,0,55,A & N ISLANDS,62
2011,0,DROWNING,0,45,10,0,37,A & N ISLANDS,47
2011,0,FALLS,0,8,0,0,8,A & N ISLANDS,8
2011,0,FIRE,0,14,12,0,2,A & N ISLANDS,14
2011,0,SUDDEN DEATHS,0,43,0,0,43,A & N ISLANDS,43
2011,0,POISONING,0,0,0,0,0,A & N ISLANDS,0
2011,0,ELECTROCUTION,0,7,0,0,7,CHANDIGARH,7
2011,0,GAS CYLINDER/STOVE BURST,0,8,7,0,1,CHANDIGARH,8
2011,0,FIRE-ARMS,0,0,0,0,0,CHANDIGARH,0
2011,0,SUDDEN DEATHS(HEART ATTACKS),0,52,2,0,50,CHANDIGARH,52
2011,0,EPILEPTIC FITS/GIDDINESS,0,1,0,0,1,CHANDIGARH,1
2011,0,ABORTIONS/CHILD BIRTH,0,0,0,0,0,CHANDIGARH,0
2011,0,INFLUENCE OF ALCOHOL,0,19,0,0,19,CHANDIGARH,19
2011,0,FOOD POISIONING/ACCIDENTAL INTAKE OF INSECTICIDES ETC.,0,1,1,0,0,CHANDIGARH,1
2011,0,SNAKE BITE/ANIMAL BITE,0,1,0,0,1,CHANDIGARH,1
2011,0,OTHER,0,4,1,0,3,CHANDIGARH,4
2011,0,OTHER RAILWAY ACCIDENTS,0,0,0,0,0,CHANDIGARH,0
2011,0,OTHER,0,118,14,0,104,CHANDIGARH,118
2011,0,DROWNING,0,4,1,0,3,CHANDIGARH,4
2011,0,FALLS,0,20,5,0,15,CHANDIGARH,20
2011,0,FIRE,0,15,13,0,2,CHANDIGARH,15
2011,0,SUDDEN DEATHS,0,72,2,0,70,CHANDIGARH,72
2011,0,POISONING,0,11,5,0,6,CHANDIGARH,11
2011,0,ELECTROCUTION,0,4,0,0,4,D & N HAVELI,4
2011,0,GAS CYLINDER/STOVE BURST,0,4,4,0,0,D & N HAVELI,4
2011,0,FIRE-ARMS,0,0,0,0,0,D & N HAVELI,0
2011,0,SUDDEN DEATHS(HEART ATTACKS),0,9,3,0,6,D & N HAVELI,9
2011,0,EPILEPTIC FITS/GIDDINESS,0,2,1,0,1,D & N HAVELI,2
2011,0,ABORTIONS/CHILD BIRTH,0,0,0,0,0,D & N HAVELI,0
2011,0,INFLUENCE OF ALCOHOL,0,5,0,0,5,D & N HAVELI,5
2011,0,FOOD POISIONING/ACCIDENTAL INTAKE OF INSECTICIDES ETC.,0,0,0,0,0,D & N HAVELI,0
2011,0,SNAKE BITE/ANIMAL BITE,0,2,1,0,1,D & N HAVELI,2
2011,0,OTHER,0,0,0,0,0,D & N HAVELI,0
2011,0,OTHER RAILWAY ACCIDENTS,0,0,0,0,0,D & N HAVELI,0
2011,0,OTHER,0,25,2,0,25,D & N HAVELI,27
2011,0,DROWNING,0,12,1,0,11,D & N HAVELI,12
2011,0,FALLS,0,6,0,0,6,D & N HAVELI,6
2011,0,FIRE,0,5,4,0,1,D & N HAVELI,5
2011,0,SUDDEN DEATHS,0,16,4,0,12,D & N HAVELI,16
2011,0,POISONING,0,2,1,0,1,D & N HAVELI,2
2011,0,ELECTROCUTION,0,5,1,0,4,DAMAN & DIU,5
2011,0,GAS CYLINDER/STOVE BURST,0,3,3,0,0,DAMAN & DIU,3
2011,0,FIRE-ARMS,0,0,0,0,0,DAMAN & DIU,0
2011,0,SUDDEN DEATHS(HEART ATTACKS),0,6,0,0,6,DAMAN & DIU,6
2011,0,EPILEPTIC FITS/GIDDINESS,0,1,0,0,1,DAMAN & DIU,1
2011,0,ABORTIONS/CHILD BIRTH,0,0,0,0,0,DAMAN & DIU,0
2011,0,INFLUENCE OF ALCOHOL,0,1,0,0,1,DAMAN & DIU,1
2011,0,FOOD POISIONING/ACCIDENTAL INTAKE OF INSECTICIDES ETC.,0,1,0,0,1,DAMAN & DIU,1
2011,0,SNAKE BITE/ANIMAL BITE,0,0,0,0,0,DAMAN & DIU,0
2011,0,OTHER,0,0,0,0,0,DAMAN & DIU,0
2011,0,OTHER RAILWAY ACCIDENTS,0,0,0,0,0,DAMAN & DIU,0
2011,0,OTHER,0,16,0,0,16,DAMAN & DIU,16
2011,0,DROWNING,0,27,0,0,27,DAMAN & DIU,27
2011,0,FALLS,0,10,0,0,10,DAMAN & DIU,10
2011,0,FIRE,0,11,7,0,4,DAMAN & DIU,11
2011,0,SUDDEN DEATHS,0,8,0,0,8,DAMAN & DIU,8
2011,0,POISONING,0,1,0,0,1,DAMAN & DIU,1
2011,28,ELECTROCUTION,0,161,20,28,128,DELHI(UT),148
2011,14,GAS CYLINDER/STOVE BURST,2,93,74,16,30,DELHI(UT),104
2011,21,FIRE-ARMS,1,55,6,22,35,DELHI(UT),41
2011,0,SUDDEN DEATHS(HEART ATTACKS),0,263,24,0,252,DELHI(UT),276
2011,0,EPILEPTIC FITS/GIDDINESS,0,24,1,0,26,DELHI(UT),27
2011,0,ABORTIONS/CHILD BIRTH,0,27,30,0,0,DELHI(UT),30
2011,0,INFLUENCE OF ALCOHOL,0,143,0,0,151,DELHI(UT),151
2011,0,FOOD POISIONING/ACCIDENTAL INTAKE OF INSECTICIDES ETC.,10,69,16,10,43,DELHI(UT),59
2011,2,SNAKE BITE/ANIMAL BITE,0,20,7,2,11,DELHI(UT),18
2011,14,OTHER,0,137,48,14,95,DELHI(UT),143
2011,355,OTHER RAILWAY ACCIDENTS,37,1409,102,392,915,DELHI(UT),1017
2011,165,OTHER,16,1286,270,181,908,DELHI(UT),1178
2011,0,DROWNING,0,182,27,0,169,DELHI(UT),196
2011,39,FALLS,5,450,96,44,379,DELHI(UT),475
2011,82,FIRE,5,296,159,87,150,DELHI(UT),309
2011,0,SUDDEN DEATHS,0,457,55,0,429,DELHI(UT),484
2011,22,POISONING,10,255,79,32,164,DELHI(UT),243
2011,0,ELECTROCUTION,0,0,0,0,0,LAKSHADWEEP,0
2011,0,GAS CYLINDER/STOVE BURST,0,1,1,0,0,LAKSHADWEEP,1
2011,0,FIRE-ARMS,0,0,0,0,0,LAKSHADWEEP,0
2011,0,SUDDEN DEATHS(HEART ATTACKS),0,0,0,0,0,LAKSHADWEEP,0
2011,0,EPILEPTIC FITS/GIDDINESS,0,0,0,0,0,LAKSHADWEEP,0
2011,0,ABORTIONS/CHILD BIRTH,0,0,0,0,0,LAKSHADWEEP,0
2011,0,INFLUENCE OF ALCOHOL,0,0,0,0,0,LAKSHADWEEP,0
2011,0,FOOD POISIONING/ACCIDENTAL INTAKE OF INSECTICIDES ETC.,0,0,0,0,0,LAKSHADWEEP,0
2011,0,SNAKE BITE/ANIMAL BITE,0,0,0,0,0,LAKSHADWEEP,0
2011,0,OTHER,0,0,0,0,0,LAKSHADWEEP,0
2011,0,OTHER RAILWAY ACCIDENTS,0,0,0,0,0,LAKSHADWEEP,0
2011,0,OTHER,0,0,0,0,0,LAKSHADWEEP,0
2011,0,DROWNING,0,5,0,0,5,LAKSHADWEEP,5
2011,0,FALLS,0,1,0,0,1,LAKSHADWEEP,1
2011,0,FIRE,0,1,1,0,0,LAKSHADWEEP,1
2011,0,SUDDEN DEATHS,0,0,0,0,0,LAKSHADWEEP,0
2011,0,POISONING,0,0,0,0,0,LAKSHADWEEP,0
2011,0,ELECTROCUTION,0,26,5,0,21,PUDUCHERRY,26
2011,0,GAS CYLINDER/STOVE BURST,0,0,0,0,0,PUDUCHERRY,0
2011,0,FIRE-ARMS,0,0,0,0,0,PUDUCHERRY,0
2011,0,SUDDEN DEATHS(HEART ATTACKS),0,63,5,0,58,PUDUCHERRY,63
2011,0,EPILEPTIC FITS/GIDDINESS,0,282,31,0,251,PUDUCHERRY,282
2011,0,ABORTIONS/CHILD BIRTH,0,0,0,0,0,PUDUCHERRY,0
2011,0,INFLUENCE OF ALCOHOL,0,226,2,0,224,PUDUCHERRY,226
2011,0,FOOD POISIONING/ACCIDENTAL INTAKE OF INSECTICIDES ETC.,0,2,1,0,1,PUDUCHERRY,2
2011,0,SNAKE BITE/ANIMAL BITE,0,15,6,0,9,PUDUCHERRY,15
2011,0,OTHER,0,3,1,0,2,PUDUCHERRY,3
2011,0,OTHER RAILWAY ACCIDENTS,0,6,0,0,6,PUDUCHERRY,6
2011,7,OTHER,0,19,0,7,12,PUDUCHERRY,12
2011,0,DROWNING,0,105,8,0,97,PUDUCHERRY,105
2011,2,FALLS,0,50,4,2,44,PUDUCHERRY,48
2011,1,FIRE,1,43,35,2,7,PUDUCHERRY,42
2011,0,SUDDEN DEATHS,0,571,38,0,533,PUDUCHERRY,571
2011,241,POISONING,254,21,8,495,12,PUDUCHERRY,20
